CD	\ˌsē-ˈdē\
DVD	\ˌdē-(ˌ)vē-ˈdē\
I	\ˈī\
OK	\ō-ˈkā , in assenting or agreeing also ˈō-ˌkā\
TV	\ˈtē-ˈvē\
a	\ˈā\
abandon	 \ə-ˈban-dən\
ability	 \ə-ˈbi-lə-tē\
able	\ˈā-bəl\
about	\ə-ˈbau̇t\
above	\ə-ˈbəv\
abroad	\ə-ˈbrȯd\
absence	 \ˈab-sən(t)s\
absolute	 \ˈab-sə-ˌlüt , ˌab-sə-ˈlüt\
absolutely	 \ˈab-sə-ˌlüt-lē , ˌab-sə-ˈlüt-\
absorb	 \əb-ˈsȯrb , -ˈzȯrb\
abuse	\ə-ˈbyüs\
academic	 \ˌa-kə-ˈde-mik\
accept	 \ik-ˈsept , ak- also ek-\
acceptable	 \ik-ˈsep-tə-bəl , ak- also ek-\
access	 \ˈak-ˌses  also ik-ˈses\
accident	 \ˈak-sə-dənt , -ˌdent , ˈaks-dənt\
accommodation	 \ə-ˌkä-mə-ˈdā-shən\
accompany	 \ə-ˈkəmp-nē , -ˈkämp-; -ˈkəm-pə-, -ˈkäm-\
according	 \ə-ˈkȯrd\
account	 \ə-ˈkau̇nt\
accurate	 \ˈa-kyə-rət , ˈa-k(ə-)rət\
accuse	 \ə-ˈkyüz\
achieve	\ə-ˈchēv\
achievement	 \ə-ˈchēv-mənt\
acid	\ˈa-səd\
acknowledge	 \ik-ˈnä-lij , ak-\
acquire	 \ə-ˈkwī(-ə)r\
across	\ə-ˈkrȯs , chiefly dialectal -ˈkrȯst\
act	\ˈakt\
action	 \ˈak-shən\
active	 \ˈak-tiv\
activist	 \ˈak-ti-vist\
activity	 \ak-ˈti-və-tē\
actor	 \ˈak-tər  also -ˌtȯr\
actual	 \ˈak-ch(ə-w)əl , -sh(ə-w)əl; -chü-əl, -shü-\
actually	 \ˈak-ch(ə-w)ə-lē , -sh(ə-w)ə-lē; ˈaksh-lē, ˈaks-\
ad	\ˈad\
adapt	\ə-ˈdapt , a-\
add	\ˈad\
addition	 \ə-ˈdi-shən , a-\
additional	 \ə-ˈdish-nəl , -ˈdi-shə-nᵊl, a-\
address	 \ə-ˈdres , a- also ˈa-ˌdres\
adequate	 \ˈa-di-kwət\
adjust	 \ə-ˈjəst\
administration	 \əd-ˌmi-nə-ˈstrā-shən , (ˌ)ad-\
administrative	 \əd-ˈmi-nə-ˌstrā-tiv , -strə-\
admire	 \əd-ˈmī(-ə)r\
admission	 \əd-ˈmi-shən , ad-\
admit	 \əd-ˈmit , ad-\
adopt	\ə-ˈdäpt\
adult	\ə-ˈdəlt , ˈa-ˌdəlt\
advance	 \əd-ˈvan(t)s\
advanced	 \əd-ˈvan(t)st\
advantage	 \əd-ˈvan-tij\
advert	 \ad-ˈvərt\
advertise	 \ˈad-vər-ˌtīz\
advertisement	 \ˌad-vər-ˈtīz-mənt ; əd-ˈvər-təz-mənt, -tə-smənt\
advertising	 \ˈad-vər-ˌtī-ziŋ\
advice	 \əd-ˈvīs\
advise	 \əd-ˈvīz\
adviser	 \əd-ˈvī-zər\
affair	 \ə-ˈfer\
affect	 \ə-ˈfekt , a-\
afford	 \ə-ˈfȯrd\
afraid	\ə-ˈfrād , Southern also ə-ˈfred\
after	 \ˈaf-tər\
afternoon	 \ˌaf-tər-ˈnün\
afterwards	 \ˈaf-tər-wərd , ˈaf-tə-\
again	\ə-ˈgen , -ˈgin, -ˈgān\
against	\ə-ˈgen(t)st , -ˈgin(t)st, -ˈgān(t)st\
age	\ˈāj\
aged	\ˈā-jəd , ˈājd; ˈājd for sense 1b\
agency	 \ˈā-jən(t)-sē\
agent	\ˈā-jənt\
aggressive	 \ə-ˈgre-siv\
ago	\ə-ˈgō\
agree	\ə-ˈgrē\
agreement	 \ə-ˈgrē-mənt\
agriculture	 \ˈa-gri-ˌkəl-chər\
ahead	\ə-ˈhed\
aid	\ˈād\
aim	\ˈām\
air	\ˈer\
aircraft	 \ˈer-ˌkraft\
airline	 \ˈer-ˌlīn\
airport	 \ˈer-ˌpȯrt\
alarm	\ə-ˈlärm\
album	 \ˈal-bəm\
alcohol	 \ˈal-kə-ˌhȯl\
alive	\ə-ˈlīv\
all	\ˈȯl\
allow	 \ə-ˈlau̇\
allowance	 \ə-ˈlau̇-ən(t)s\
almost	 \ˈȯl-ˌmōst , ȯl-ˈmōst\
alone	\ə-ˈlōn\
along	\ə-ˈlȯŋ\
alongside	 \ə-ˈlȯŋ-ˈsīd\
already	 \ȯl-ˈre-dē , ˈȯl-ˌre-dē\
also	 \ˈȯl(t)-(ˌ)sō , ˈȯ-\
alter	 \ˈȯl-tər\
alternative	 \ȯl-ˈtər-nə-tiv , al-\
although	 \ȯl-ˈt͟hō\
altogether	 \ˌȯl-tə-ˈge-t͟hər\
always	 \ˈȯl-wēz , -wəz, -(ˌ)wāz  also ˈȯ-\
amazing	 \ə-ˈmā-ziŋ\
ambition	 \am-ˈbi-shən\
ambulance	 \ˈam-byə-lən(t)s , -bə- also -ˌlan(t)s\
among	\ə-ˈməŋ\
amount	\ə-ˈmau̇nt\
an	\ən, (ˈ)an\
an	\ən, (ˈ)an\
analysis	 \ə-ˈna-lə-səs\
analyst	 \ˈa-nə-ləst\
ancient	 \ˈān(t)-shənt , ˈāŋ(k)-shənt\
and	\ən(d), (ˈ)an(d) , usually ᵊn(d), after t, d , s or z; often ᵊm, after p or b; sometimes ᵊŋ, after k or g\
anger	 \ˈaŋ-gər\
angle	 \ˈaŋ-gəl\
angry	 \ˈaŋ-grē\
animal	 \ˈa-nə-məl\
announce	 \ə-ˈnau̇n(t)s\
announcement	 \ə-ˈnau̇n(t)-smənt\
annoy	 \ə-ˈnȯi\
annual	 \ˈan-yə(-wə)l , -yü-əl\
another	 \ə-ˈnə-t͟hər  also a- or ā-\
answer	 \ˈan(t)-sər\
anticipate	 \an-ˈti-sə-ˌpāt\
anxiety	 \aŋ-ˈzī-ə-tē\
anxious	 \ˈaŋ(k)-shəs\
any	\ˈe-nē\
anybody	 \ˈe-nē-(ˌ)bə-dē , -ˌbä-\
anyhow	 \ˈe-nē-ˌhau̇\
anyone	 \ˈe-nē-(ˌ)wən\
anything	 \ˈe-nē-ˌthiŋ\
anyway	 \ˈe-nē-ˌwā\
anywhere	 \ˈe-nē-ˌ(h)wer , -(h)wər\
apart	\ə-ˈpärt\
apartment	 \ə-ˈpärt-mənt\
apologize	 \ə-ˈpä-lə-ˌjīz\
apology	 \ə-ˈpä-lə-jē\
apparent	 \ə-ˈper-ənt , -ˈpa-rənt\
apparently	 \ə-ˈper-ənt-lē , -ˈpa-rənt\
appeal	 \ə-ˈpēl\
appear	 \ə-ˈpir\
appearance	 \ə-ˈpir-ən(t)s\
apple	 \ˈa-pəl\
application	 \ˌa-plə-ˈkā-shən\
apply	 \ə-ˈplī\
appoint	 \ə-ˈpȯint\
appointment	 \ə-ˈpȯint-mənt\
appreciate	 \ə-ˈprē-shē-ˌāt , -ˈpri-  also -ˈprē-sē-\
approach	 \ə-ˈprōch\
appropriate	 \ə-ˈprō-prē-ət\
approval	 \ə-ˈprü-vəl\
approve	 \ə-ˈprüv\
an	\ən, (ˈ)an\
analysis	 \ə-ˈna-lə-səs\
analyst	 \ˈa-nə-ləst\
ancient	 \ˈān(t)-shənt , ˈāŋ(k)-shənt\
and	\ən(d), (ˈ)an(d) , usually ᵊn(d), after t, d , s or z; often ᵊm, after p or b; sometimes ᵊŋ, after k or g\
anger	 \ˈaŋ-gər\
angle	 \ˈaŋ-gəl\
angry	 \ˈaŋ-grē\
animal	 \ˈa-nə-məl\
announce	 \ə-ˈnau̇n(t)s\
announcement	 \ə-ˈnau̇n(t)-smənt\
annoy	 \ə-ˈnȯi\
annual	 \ˈan-yə(-wə)l , -yü-əl\
another	 \ə-ˈnə-t͟hər  also a- or ā-\
answer	 \ˈan(t)-sər\
anticipate	 \an-ˈti-sə-ˌpāt\
anxiety	 \aŋ-ˈzī-ə-tē\
anxious	 \ˈaŋ(k)-shəs\
any	\ˈe-nē\
anybody	 \ˈe-nē-(ˌ)bə-dē , -ˌbä-\
anyhow	 \ˈe-nē-ˌhau̇\
anyone	 \ˈe-nē-(ˌ)wən\
anything	 \ˈe-nē-ˌthiŋ\
anyway	 \ˈe-nē-ˌwā\
anywhere	 \ˈe-nē-ˌ(h)wer , -(h)wər\
apart	\ə-ˈpärt\
apartment	 \ə-ˈpärt-mənt\
apologize	 \ə-ˈpä-lə-ˌjīz\
apology	 \ə-ˈpä-lə-jē\
apparent	 \ə-ˈper-ənt , -ˈpa-rənt\
apparently	 \ə-ˈper-ənt-lē , -ˈpa-rənt\
appeal	 \ə-ˈpēl\
appear	 \ə-ˈpir\
appearance	 \ə-ˈpir-ən(t)s\
apple	 \ˈa-pəl\
application	 \ˌa-plə-ˈkā-shən\
apply	 \ə-ˈplī\
appoint	 \ə-ˈpȯint\
appointment	 \ə-ˈpȯint-mənt\
appreciate	 \ə-ˈprē-shē-ˌāt , -ˈpri-  also -ˈprē-sē-\
approach	 \ə-ˈprōch\
appropriate	 \ə-ˈprō-prē-ət\
approval	 \ə-ˈprü-vəl\
approve	 \ə-ˈprüv\
approximate	 \ə-ˈpräk-sə-mət\
architect	 \ˈär-kə-ˌtekt\
architecture	 \ˈär-kə-ˌtek-chər\
area	 \ˈer-ē-ə , ˈā-rē-ə\
argue	 \ˈär-(ˌ)gyü\
argument	 \ˈär-gyə-mənt\
arise	\ə-ˈrīz\
arm	\ˈärm\
armed	\ˈärmd\
army	 \ˈär-mē\
around	\ə-ˈrau̇nd\
arrange	 \ə-ˈrānj\
arrangement	 \ə-ˈrānj-mənt\
arrest	 \ə-ˈrest\
arrival	 \ə-ˈrī-vəl\
arrive	 \ə-ˈrīv\
art	\ˈärt\
article	 \ˈär-ti-kəl\
artificial	 \ˌär-tə-ˈfi-shᵊl\
artist	 \ˈär-tist\
as	\əz, (ˌ)az\
ashamed	\ə-ˈshāmd\
aside	\ə-ˈsīd\
ask	\ˈask , ˈäsk ; dialectal ˈaks\
asleep	\ə-ˈslēp\
aspect	 \ˈa-ˌspekt\
assess	 \ə-ˈses , a-\
assessment	 \ə-ˈses-mənt , a-\
assignment	 \ə-ˈsīn-mənt\
assist	 \ə-ˈsist\
assistance	 \ə-ˈsi-stən(t)s\
assistant	 \ə-ˈsi-stənt\
associate	 \ə-ˈsō-shē-ˌāt , -sē-\
association	 \ə-ˌsō-sē-ˈā-shən , -shē-\
assume	 \ə-ˈsüm\
assumption	 \ə-ˈsəm(p)-shən\
assure	 \ə-ˈshu̇r\
at	\ət, ˈat\
atmosphere	 \ˈat-mə-ˌsfir\
attach	 \ə-ˈtach\
attack	 \ə-ˈtak\
attempt	 \ə-ˈtem(p)t\
attend	 \ə-ˈtend\
attention	 \ə-ˈten(t)-shən , sense 4 often (ə-)ˌten(ch)-ˈhət\
attitude	 \ˈa-tə-ˌtüd , -ˌtyüd\
attorney	 \ə-ˈtər-nē\
attract	 \ə-ˈtrakt\
attraction	 \ə-ˈtrak-shən\
attractive	 \ə-ˈtrak-tiv\
audience	 \ˈȯ-dē-ən(t)s , ˈä-\
aunt	\ˈant , ˈänt\
author	 \ˈȯ-thər\
authority	 \ə-ˈthȯr-ə-tē , ȯ-, -ˈthär-\
automatic	 \ˌȯ-tə-ˈma-tik\
automatically	 \ˌȯ-tə-ˈma-tik\
autumn	 \ˈȯ-təm\
available	 \ə-ˈvā-lə-bəl\
average	 \ˈa-v(ə-)rij\
avoid	\ə-ˈvȯid\
awake	\ə-ˈwāk\
award	\ə-ˈwȯrd\
aware	\ə-ˈwer\
awareness	 \ə-ˈwer-nəs\
away	\ə-ˈwā\
awful	 \ˈȯ-fəl\
awkward	 \ˈȯ-kwərd\
baby	 \ˈbā-bē\
back	\ˈbak\
background	 \ˈbak-ˌ(g)rau̇nd\
backwards	 \ˈbak-wərd\
bacon	 \ˈbā-kən, sometimes -kᵊŋ\
bad	\ˈbad\
badly	 \ˈbad-lē\
bag	\ˈbag also ˈbāg\
bake	\ˈbāk\
balance	 \ˈba-lən(t)s\
ball	\ˈbȯl\
ban	\ˈban\
band	\ˈband\
bang	\ˈbaŋ\
bank	\ˈbaŋk\
bar	\ˈbär\
barrier	 \ˈber-ē-ər , ˈba-rē-\
base	\ˈbās\
baseball	 \ˈbās-ˌbȯl\
basic	 \ˈbā-sik also -zik\
basically	 \ˈbā-si-k(ə-)lē also -zi-\
basis	 \ˈbā-səs\
basket	 \ˈba-skit , British also ˈbäs-\
bat	\ˈbat\
bath	\ˈbath , ˈbäth\
bathroom	 \ˈbath-ˌrüm , -ˌru̇m, ˈbäth-\
battery	 \ˈba-t(ə-)rē\
battle	 \ˈba-tᵊl\
be	\ˈbē\
beach	\ˈbēch\
bean	\ˈbēn\
bear	\ˈber\
beard	\ˈbird\
beat	\ˈbēt\
beautiful	 \ˈbyü-ti-fəl\
beauty	 \ËˆbyÃ¼-tÄ“\
because	 \bi-ˈkȯz , -ˈkəz, -ˈkȯs, bē-\
become	 \bi-ˈkəm , bē-\
bed	\ˈbed\
bedroom	 \ˈbed-ˌrüm , -ˌru̇m\
beef	\ˈbēf\
beer	\ˈbir\
before	 \bi-ˈfȯr , bē-\
beforehand	 \bi-ˈfȯr-ˌhand , bē-\
begin	 \bi-ˈgin , bē-\
beginning	 \bi-ˈgi-niŋ , bē-\
behalf	 \bi-ˈhaf , -ˈhäf, bē-\
behave	 \bi-ˈhāv , bē-\
behind	 \bi-ˈhīnd , bē-\
being	 \ˈbē(-i)ŋ\
belief	 \bə-ˈlēf\
believe	 \bə-ˈlēv\
bell	\ˈbel\
belong	 \bi-ˈlȯŋ , bē-\
below	 \bi-ˈlō\
belt	\ˈbelt\
bench	\ˈbench\
bend	\ˈbend\
beneath	 \bi-ˈnēth , bē-\
benefit	 \ˈbe-nə-ˌfit\
beside	 \bi-ˈsīd , bē-\
best	\ˈbest\
bet	\ˈbet\
better	 \ˈbe-tər\
between	 \bi-ˈtwēn , bē-\
beyond	 \bē-ˈänd\
bicycle	 \ˈbī-si-kəl , -ˌsi- also -ˌsī-\
bid	\ˈbid\
big	\ˈbig\
bike	\ˈbīk\
bill	\ˈbil\
bin	\ˈbin\
bird	\ˈbərd\
birth	\ˈbərth\
birthday	 \ˈbərth-ˌdā\
biscuit	 \ˈbi-skət\
bit	\ˈbit\
bite	\ˈbīt\
bitter	 \ˈbi-tər\
black	\ˈblak\
blade	\ˈblād\
blame	\ˈblām\
blank	\ˈblaŋk\
bless	\ˈbles\
blind	\ˈblīnd\
block	\ˈbläk\
bloke	\ˈblōk\
blonde	\ˈbländ\
blood	\ˈbləd\
blow	\ˈblō\
blue	\ˈblü\
board	\ˈbȯrd\
boat	\ˈbōt\
body	\ˈbä-dē\
boil	\ˈbȯi(-ə)l\
boiler	 \ˈbȯi-lər\
boiling	 \ˈbȯi(-ə)-liŋ\
bomb	\ˈbäm\
bone	\ˈbōn\
bonus	 \ˈbō-nəs\
book	\ˈbu̇k\
boom	\ˈbüm\
boot	\ˈbüt\
border	 \ˈbȯr-dər\
bored	\ˈbȯrd\
boring	 \ˈbȯr-iŋ\
born	\ˈbȯrn\
borrow	 \ˈbär-(ˌ)ō , ˈbȯr-\
boss	\ˈbȯs , ˈbäs\
both	\ˈbōth\
bother	 \ˈbä-t͟hər\
bottle	 \ˈbä-tᵊl\
bottom	 \ˈbä-təm\
bounce	\ˈbau̇n(t)s\
bound	\ˈbau̇nd\
bowl	\ˈbōl\
box	\ˈbäks\
boy	\ˈbȯi\
boyfriend	 \ˈbȯi-ˌfrend\
brain	\ˈbrān\
branch	\ˈbranch\
brave	\ˈbrāv\
bread	\ˈbred\
break	\ˈbrāk\
breakfast	 \ˈbrek-fəst\
breast	\ˈbrest\
breath	\ˈbreth\
breathe	\ˈbrēt͟h\
brick	\ˈbrik\
bridge	\ˈbrij\
brief	\ˈbrēf\
briefly	 \ˈbrē-flē\
bright	\ˈbrīt\
brilliant	 \ˈbril-yənt\
bring	\ˈbriŋ\
broad	\ˈbrȯd\
brother	 \ˈbrə-t͟hər\
brown	\ˈbrau̇n\
brush	\ˈbrəsh\
buck	\ˈbək\
bucket	 \ˈbə-kət\
buddy	 \ˈbə-dē\
budget	 \ˈbə-jət\
bug	\ˈbəg\
build	\ˈbild\
builder	 \ˈbil-dər\
building	 \ˈbil-diŋ\
bump	\ˈbəmp\
bunch	\ˈbənch\
burn	\ˈbərn\
burst	\ˈbərst\
bury	\ˈber-ē , ˈbe-rē also ˈbər-\
bus	\ˈbəs\
business	 \ˈbiz-nəs , -nəz, Southern also ˈbid-\
busy	\ˈbi-zē\
but	\ˈbət\
butcher	 \ˈbu̇-chər\
butter	 \ˈbə-tər\
button	 \ˈbə-tᵊn\
buy	\ˈbī\
buyer	 \ˈbī(-ə)r\
by	\ˈbī , before consonants also bə\
bye	\ˈbī\
cabinet	 \ˈkab-nit , ˈka-bə-\
cable	 \ˈkā-bəl\
cake	\ˈkāk\
calculate	 \ˈkal-kyə-ˌlāt\
calculation	 \ˌkal-kyə-ˈlā-shən\
calculator	 \ˈkal-kyə-ˌlā-tər\
calendar	 \ˈka-lən-dər\
call	\ˈkȯl\
calm	\ˈkäm , ˈkälm , ˈkam, ˈkȯ(l)m\
camera	 \ˈkam-rə , ˈka-mə-rə\
camp	\ˈkamp\
campaign	 \(ˌ)kam-ˈpān\
can	\kən, ˈkan  also ˈken; dialectal ˈkin\
cancel	 \ˈkan(t)-səl\
cancer	 \ˈkan(t)-sər\
candidate	 \ˈkan-də-ˌdāt , ˈka-nə-, -dət\
candle	 \ˈkan-dᵊl\
candy	 \ˈkan-dē\
cap	\ˈkap\
capable	 \ˈkā-pə-bəl , in rapid speech ˈkāp-bəl\
capacity	 \kə-ˈpa-sə-tē , -ˈpa-stē\
capital	 \ˈka-pə-tᵊl , ˈkap-tᵊl\
captain	 \ˈkap-tən also ˈkap-ᵊm\
capture	 \ˈkap-chər , -shər\
car	\ˈkär , dialectal also ˈkȯr, ˈkyär\
card	\ˈkärd\
care	\ˈker\
career	 \kə-ˈrir\
careful	 \ˈker-fəl\
carefully	 \ˈker-fəl\
carpet	 \ˈkär-pət\
carrot	 \ˈker-ət , ˈka-rət\
carry	 \ˈker-ē , ˈka-rē\
cartoon	 \kär-ˈtün\
case	\ˈkās\
cash	\ˈkash\
cast	\ˈkast\
castle	 \ˈka-səl\
cat	\ˈkat\
catalogue	 \ˈka-tə-ˌlȯg , -ˌläg\
catch	\ˈkach , ˈkech\
category	 \ˈka-tə-ˌgȯr-ē\
cause	\ˈkȯz\
cease	\ˈsēs\
ceiling	 \ˈsē-liŋ\
celebrate	 \ˈse-lə-ˌbrāt\
celebration	 \ˈse-lə-ˌbrāt\
cell	\ˈsel\
cent	\ˈsent\
centimetre	 \ˈsen-tə-ˌmē-tər , ˈsän-\
central	 \ˈsen-trəl\
century	 \ˈsen(t)-sh(ə-)rē\
cereal	 \ˈsir-ē-əl\
certain	 \ˈsər-tᵊn\
certainly	 \ˈsər-tᵊn-lē\
certificate	 \(ˌ)sər-ˈti-fi-kət\
chain	\ˈchān\
chair	\ˈcher\
chairman	 \ˈcher-mən\
challenge	 \ˈcha-lənj\
champion	 \ˈcham-pē-ən\
championship	 \ˈcham-pē-ən-ˌship\
chance	\ˈchan(t)s\
change	\ˈchānj\
channel	 \ˈcha-nᵊl\
chap	\ˈchap\
chapter	 \ˈchap-tər\
character	 \ˈker-ik-tər , ˈka-rik-\
characteristic	 \ˌker-ik-tə-ˈri-stik , ˌka-rik-\
characterize	 \ˈker-ik-tə-ˌrīz , ˈka-rik-\
charge	\ˈchärj\
charity	 \ˈcher-ə-tē , ˈcha-rə-\
chart	\ˈchärt\
chase	\ˈchās\
chat	\ˈchat\
cheap	\ˈchēp\
cheat	\ˈchēt\
check	\ˈchek\
cheek	\ˈchēk\
cheese	\ˈchēz\
chemical	 \ˈke-mi-kəl\
chemist	 \ˈke-mist\
chemistry	 \ˈke-mə-strē\
cherry	 \ˈcher-ē , ˈche-rē\
chest	\ˈchest\
chicken	 \ˈchi-kᵊn , sometimes -kᵊŋ\
chief	\ˈchēf\
child	\ˈchī(-ə)ld\
childhood	 \ˈchī(-ə)ld-ˌhu̇d\
chip	\ˈchip\
chocolate	 \ˈchä-k(ə-)lət , ˈchȯ-\
choice	\ˈchȯis\
choose	\ˈchüz\
chop	\ˈchäp\
chuck	\ˈchək\
church	\ˈchərch\
cigarette	 \ˌsi-gə-ˈret , ˈsi-gə-ˌret\
cinema	 \ˈsi-nə-mə , British also -ˌmä\
circle	 \ˈsər-kəl\
circuit	 \ˈsər-kət\
circumstance	 \ˈsər-kəm-ˌstan(t)s , -stən(t)s\
citizen	 \ˈsi-tə-zən  also -sən\
city	\ˈsi-tē\
civil	 \ˈsi-vəl\
claim	\ˈklām\
class	\ˈklas\
classic	 \ˈkla-sik\
classical	 \ˈkla-si-kəl\
classroom	 \ˈklas-ˌrüm , -ˌru̇m\
clean	\ˈklēn\
cleaner	 \ˈklē-nər\
clear	\ˈklir\
clearly	 \ˈklir-lē\
clerk	\ˈklərk , British usually ˈklärk\
clever	 \ˈkle-vər\
click	\ˈklik\
client	 \ˈklī-ənt\
climate	 \ˈklī-mət\
climb	\ˈklīm\
clock	\ˈkläk\
close	\ˈklōz\
closed	\ˈklōzd\
closely	\ˈklōz\
closet	 \ˈklä-zət , ˈklȯ-\
cloth	\ˈklȯth\
clothes	\ˈklōz  also ˈklōt͟hz\
cloud	\ˈklau̇d\
club	\ˈkləb\
clue	\ˈklü\
coach	\ˈkōch\
coal	\ˈkōl\
coast	\ˈkōst\
coat	\ˈkōt\
code	\ˈkōd\
coffee	 \ˈkȯ-fē , ˈkä-\
coin	\ˈkȯin\
cold	\ˈkōld\
collapse	 \kə-ˈlaps\
collar	 \ˈkä-lər\
colleague	 \ˈkä-(ˌ)lēg\
collect	 \ˈkä-likt also -ˌlekt\
collection	 \kə-ˈlek-shən\
college	 \ˈkä-lij\
colour	 \ˈkə-lər\
column	 \ˈkä-ləm also ˈkäl-yəm\
combination	 \ˌkäm-bə-ˈnā-shən\
combine	 \kəm-ˈbīn\
come	\ˈkəm\
comfort	 \ˈkəm(p)-fərt\
comfortable	 \ˈkəm(p)(f)-tər-bəl , ˈkəm(p)(f)-tə-bəl, ˈkəm(p)-fər-tə-bəl, ˈkəm(p)-fə-tə-bəl, ˈkəm-fər-bəl, ˈkəm-fə-bəl\
command	 \kə-ˈmand\
comment	 \ˈkä-ˌment\
commercial	 \kə-ˈmər-shəl\
commission	 \kə-ˈmi-shən\
commit	 \kə-ˈmit\
commitment	 \kə-ˈmit-mənt\
committee	 \kə-ˈmi-tē , sense 2 also ˌkä-mi-ˈtē\
common	 \ˈkä-mən\
communicate	 \kə-ˈmyü-nə-ˌkāt\
communication	 \kə-ˌmyü-nə-ˈkā-shən\
community	 \kə-ˈmyü-nə-tē\
company	 \ˈkəmp-nē , ˈkəm-pə-\
compare	 \kəm-ˈper\
comparison	 \kəm-ˈper-ə-sən , -ˈpa-rə-\
compete	 \kəm-ˈpēt\
competition	 \ˌkäm-pə-ˈti-shən\
competitive	 \kəm-ˈpe-tə-tiv\
complain	 \kəm-ˈplān\
complaint	 \kəm-ˈplānt\
complete	 \kəm-ˈplēt\
completely	 \kəm-ˈplēt\
complex	 \ˈkäm-ˌpleks\
complicated	 \ˈkäm-plə-ˌkā-təd\
constitute	 \ˈkän(t)-stə-ˌtüt , -ˌtyüt\
construct	 \kən-ˈstrəkt\
construction	 \kən-ˈstrək-shən\
consult	 \kən-ˈsəlt\
consumer	 \kən-ˈsü-mər\
consumption	 \kən-ˈsəm(p)-shən\
contact	 \ˈkän-ˌtakt\
contain	 \kən-ˈtān\
contemporary	 \kən-ˈtem-pə-ˌrer-ē , -ˌre-rē\
content	 \ˈkän-ˌtent\
contest	 \kən-ˈtest , ˈkän-ˌtest\
context	 \ˈkän-ˌtekst\
continue	 \kən-ˈtin-(ˌ)yü\
continuous	 \kən-ˈtin-yü-əs\
contract	 \ˈkän-ˌtrakt\
contrast	 \kən-ˈtrast , ˈkän-ˌtrast\
contribute	 \kən-ˈtri-byət , -(ˌ)byüt also and especially before -​ed or -​ing -ˈtri-bət; chiefly British also ˈkän-trə-ˌbyüt\
contribution	 \ˌkän-trə-ˈbyü-shən\
control	 \kən-ˈtrōl\
convenient	 \kən-ˈvēn-yənt\
convention	 \kən-ˈven(t)-shən\
conventional	 \kən-ˈvench-nəl , -ˈven(t)-shə-nᵊl\
conversation	 \ˌkän-vər-ˈsā-shən\
convert	 \kən-ˈvərt\
conviction	 \kən-ˈvik-shən\
convince	 \kən-ˈvin(t)s\
cook	\ˈku̇k\
cooker	 \ˈku̇-kər\
cookie	 \ˈku̇-kē\
cool	\ˈkül\
cooperation	 \(ˌ)kō-ˌä-pə-ˈrā-shən\
cope	\ˈkōp\
copy	\ˈkä-pē\
core	\ˈkȯr\
corn	\ˈkȯrn\
corner	 \ˈkȯr-nər\
correct	 \kə-ˈrekt\
corridor	 \ˈkȯr-ə-dər , ˈkär-, -ˌdȯr\
cost	\ˈkȯst\
cottage	 \ˈkä-tij\
cotton	 \ˈkä-tᵊn\
could	\kəd, ˈku̇d\
council	 \ˈkau̇n(t)-səl\
count	\ˈkau̇nt , dialectal ˈkyau̇nt\
counter	 \ˈkau̇n-tər\
country	 \ˈkən-trē\
countryside	 \ˈkən-trē-ˌsīd\
county	 \ˈkau̇n-tē\
couple	 \ˈkə-pəl ; "couple of" is often ˌkə-plə(v)\
courage	 \ˈkər-ij , ˈkə-rij\
course	\ˈkȯrs\
court	\ˈkȯrt\
cousin	 \ˈkə-zən\
cover	 \ˈkə-vər\
cow	\ˈkau̇\
crack	\ˈkrak\
craft	\ˈkraft\
crash	\ˈkrash\
crazy	 \ˈkrā-zē\
create	 \krē-ˈāt , ˈkrē-ˌāt\
creation	 \krē-ˈā-shən\
creative	 \krē-ˈā-tiv , ˈkrē-ˌā-\
creature	 \ˈkrē-chər\
credit	 \ˈkre-dit\
crew	\ˈkrü\
crime	\ˈkrīm\
criminal	 \ˈkri-mə-nᵊl , ˈkrim-nəl\
crisis	 \ˈkrī-səs\
criterion	 \krī-ˈtir-ē-ən also krə-\
critic	 \ˈkri-tik\
critical	 \ˈkri-ti-kəl\
criticism	 \ˈkri-tə-ˌsi-zəm\
criticize	 \ˈkri-tə-ˌsīz\
crop	\ˈkräp\
cross	\ˈkrȯs\
crowd	\ˈkrau̇d\
crown	\ˈkrau̇n\
crucial	 \ˈkrü-shəl\
cruel	 \ˈkrü(-ə)l\
cry	\ˈkrī\
cultural	 \ˈkəlch-rəl , ˈkəl-chə-\
culture	 \ˈkəl-chər\
cup	\ˈkəp\
cupboard	 \ˈkə-bərd\
curious	 \ˈkyu̇r-ē-əs , ˈkyər-\
currency	 \ˈkər-ən(t)-sē , ˈkə-rən(t)-\
current	 \ˈkər-ənt , ˈkə-rənt\
currently	 \ˈkər-ənt-lē , ˈkə-rənt-\
curtain	 \ˈkər-tᵊn\
curve	\ˈkərv\
cushion	 \ˈku̇-shən\
custom	 \ˈkə-stəm\
customer	 \ˈkə-stə-mər\
cut	\ˈkət\
cute	\ˈkyüt\
cycle	 \ˈsī-kəl\
dad	\ˈdad\
daddy	 \ˈda-dē\
daft	\ˈdaft  also ˈdäft\
daily	 \ˈdā-lē\
damage	 \ˈda-mij\
dance	\ˈdan(t)s , ˈdän(t)s\
danger	 \ˈdān-jər\
dangerous	 \ˈdān-jə-rəs ; ˈdān-jərs, -zhrəs\
dare	\ˈder\
dark	\ˈdärk\
darkness	\ˈdärk\
darling	 \ˈdär-liŋ\
data	 \ˈdā-tə , ˈda-  also ˈdä-\
database	 \ˈdā-tə-ˌbās , ˈda- also ˈdä-\
date	\ˈdāt\
daughter	 \ˈdȯ-tər , ˈdä-\
day	\ˈdā\
dead	\ˈded\
deaf	\ˈdef , dialectal ˈdēf\
deal	\ˈdēl\
dealer	\ˈdēl\
dear	\ˈdir\
death	\ˈdeth\
debate	 \di-ˈbāt , dē-\
debt	\ˈdet\
decade	 \ˈde-ˌkād , de-ˈkād; especially sense 1b ˈde-kəd\
decent	 \ˈdē-sᵊnt\
decide	 \di-ˈsīd , dē-\
decision	 \di-ˈsi-zhən\
declare	 \di-ˈkler\
decline	 \di-ˈklīn , dē-\
deep	\ˈdēp\
deeply	\ˈdēp\
defeat	 \di-ˈfēt , dē-\
defend	 \di-ˈfend\
define	 \di-ˈfīn\
definite	 \ˈde-fə-nit , ˈdef-nət\
definitely	 \ˈde-fə-nit-lē , ˈdef-nət-\
definition	 \ˌde-fə-ˈni-shən\
degree	 \di-ˈgrē\
delay	 \di-ˈlā , dē-\
deliberately	 \di-ˈli-bə-rət-lē , -ˈlib-rət-\
deliver	 \di-ˈli-vər , dē-\
delivery	 \di-ˈli-v(ə-)rē , dē-\
demand	 \di-ˈmand , -ˈmänd, dē-\
democracy	 \di-ˈmä-krə-sē\
democratic	 \ˌde-mə-ˈkra-tik\
demonstrate	 \ˈde-mən-ˌstrāt\
demonstration	 \ˌde-mən-ˈstrā-shən\
dentist	 \ˈden-təst\
deny	 \di-ˈnī , dē-\
department	 \di-ˈpärt-mənt\
departure	 \di-ˈpär-chər\
depend	 \di-ˈpend\
dependent	 \di-ˈpen-dənt\
deposit	 \di-ˈpä-zət\
depression	 \di-ˈpre-shən , dē-\
depth	\ˈdepth\
derive	 \di-ˈrīv , dē-\
describe	 \di-ˈskrīb\
description	 \di-ˈskrip-shən\
desert	 \ˈde-zərt\
deserve	 \di-ˈzərv\
design	 \di-ˈzīn\
designer	 \di-ˈzī-nər\
desire	 \di-ˈzī(-ə)r , dē-\
desk	\ˈdesk\
desperate	 \ˈde-sp(ə-)rət , -spərt\
despite	 \di-ˈspīt\
destroy	 \di-ˈstrȯi , dē-\
destruction	 \di-ˈstrək-shən\
detail	 \di-ˈtāl , ˈdē-ˌtāl\
detailed	 \di-ˈtāld , ˈdē-ˌtāld\
detect	 \di-ˈtekt , dē-\
determination	 \di-ˌtər-mə-ˈnā-shən\
determine	 \di-ˈtər-mən , dē-\
determined	 \di-ˈtər-mənd , dē-\
develop	 \di-ˈve-ləp , dē-\
development	 \di-ˈve-ləp-mənt , dē-\
device	 \di-ˈvīs\
devil	 \ˈde-vᵊl , dialectal ˈdi-\
diagram	 \ˈdī-ə-ˌgram\
diamond	 \ˈdī-(ə-)mənd\
diary	 \ˈdī-(ə-)rē\
die	\ˈdī\
diet	 \ˈdī-ət\
differ	 \ˈdi-fər\
difference	 \ˈdi-f(ə-)rən(t)s , ˈdi-fərn(t)s\
different	 \ˈdi-f(ə-)rənt , ˈdi-fərnt\
difficult	 \ˈdi-fi-(ˌ)kəlt\
difficulty	 \ˈdi-fi-(ˌ)kəl-tē\
dig	\ˈdig\
dimension	 \də-ˈmen(t)-shən  also dī-\
dinner	 \ˈdi-nər\
direct	 \də-ˈrekt , dī-\
direction	 \də-ˈrek-shən , dī-\
directly	 \də-ˈrek(t)-lē , dī-, in sense 2 especially də-ˈrek-lē or ˈdrek-lē\
director	 \də-ˈrek-tər , dī-\
directory	 \də-ˈrek-t(ə-)rē , dī-\
dirt	\ˈdərt\
dirty	\ˈdər-tē\
disabled	 \dis-ˈā-bəld , diz-ˈā-\
disagree	 \ˌdis-ə-ˈgrē\
disappear	 \ˌdis-ə-ˈpir\
disappoint	 \ˌdis-ə-ˈpȯint\
disappointed	 \ˌdis-ə-ˈpȯin-təd\
disaster	 \di-ˈza-stər , -ˈsa-\
discipline	 \ˈdi-sə-plən\
discount	 \ˈdi-ˌskau̇nt\
discover	 \di-ˈskə-vər\
discovery	 \di-ˈskə-v(ə-)rē\
discuss	 \di-ˈskəs\
discussion	 \di-ˈskə-shən\
disease	 \di-ˈzēz\
disgusting	 \di-ˈskə-stiŋ , dis-ˈgə- also diz-\
dish	\ˈdish\
disk	\ˈdisk\
dismiss	 \dis-ˈmis\
display	 \di-ˈsplā\
dispute	 \di-ˈspyüt\
distance	 \ˈdi-stən(t)s\
distant	 \ˈdi-stənt\
distinct	 \di-ˈstiŋ(k)t\
distinction	 \di-ˈstiŋ(k)-shən\
distinguish	 \di-ˈstiŋ-(g)wish\
distribute	 \di-ˈstri-byüt  also -byət , British also ˈdi-stri-ˌbyüt\
distribution	 \ˌdi-strə-ˈbyü-shən\
district	 \ˈdi-(ˌ)strikt\
disturb	 \di-ˈstərb\
divide	 \də-ˈvīd\
division	 \də-ˈvi-zhən\
divorce	 \də-ˈvȯrs  also dī-\
do	\ˈdü\
doctor	 \ˈdäk-tər\
document	 \ˈdä-kyə-mənt , -kyü-\
dog	\ˈdȯg , ˈdäg\
dollar	 \ˈdä-lər\
domestic	 \də-ˈme-stik\
dominant	 \ˈdä-mə-nənt , ˈdäm-nənt\
dominate	 \ˈdä-mə-ˌnāt\
door	\ˈdȯr\
dot	\ˈdät\
double	 \ˈdə-bəl\
doubt	\ˈdau̇t\
down	\ˈdau̇n\
downstairs	 \ˈdau̇n-ˈsterz\
downtown	 \ˌdau̇n-ˈtau̇n\
dozen	 \ˈdə-zᵊn\
draft	\ˈdraft , ˈdräft\
drag	\ˈdrag\
drama	 \ˈdrä-mə , ˈdra-\
dramatic	 \drə-ˈma-tik\
draw	\ˈdrȯ\
drawer	 \ˈdrȯ(-ə)r\
drawing	 \ˈdrȯ(-)iŋ\
dream	\ˈdrēm\
dress	\ˈdres\
drink	\ˈdriŋk\
drive	\ˈdrīv\
driver	 \ˈdrī-vər\
drop	\ˈdräp\
drug	\ˈdrəg\
drunk	\ˈdrəŋk\
dry	\ˈdrī\
dude	\ˈdüd  also ˈdyüd\
due	\ˈdü , ˈdyü\
dull	\ˈdəl\
dumb	\ˈdəm\
dump	\ˈdəmp\
during	 \ˈdu̇r-iŋ  also ˈdyu̇r-\
dust	\ˈdəst\
duty	 \ˈdü-tē  also ˈdyü-\
each	\ˈēch\
ear	\ˈir\
early	 \ˈər-lē\
earn	\ˈərn\
earth	\ˈərth\
ease	\ˈēz\
easily	 \ˈēz-lē , ˈē-zə-\
east	\ˈēst\
eastern	 \ˈē-stərn\
easy	\ˈē-zē\
eat	\ˈēt\
economic	 \ˌe-kə-ˈnä-mik , ˌē-kə-\
economics	 \ˌe-kə-ˈnä-miks , ˌē-kə-\
economy	 \i-ˈkä-nə-mē , ə-, ē-\
edge	\ˈej\
edition	 \i-ˈdi-shən\
editor	 \ˈe-də-tər\
education	 \ˌe-jə-ˈkā-shən\
educational	 \ˌe-jə-ˈkā-shən\
effect	 \i-ˈfekt , e-, ē-, ə-\
effective	 \i-ˈfek-tiv , e-, ē-, ə-\
effectively	 \i-ˈfek-tiv-lē , e-, ē-, ə-\
efficiency	 \i-ˈfi-shən-sē\
efficient	 \i-ˈfi-shənt\
effort	 \ˈe-fərt , -ˌfȯrt\
egg	\ˈeg , ˈāg\
either	 \ˈē-t͟hər  also ˈī-\
elderly	 \ˈel-dər-lē\
elect	\i-ˈlekt\
election	 \i-ˈlek-shən\
electric	 \i-ˈlek-trik , ē-\
electrical	 \i-ˈlek-trik , ē-\
electricity	 \i-ˌlek-ˈtri-sə-tē , ē-, -ˈtri-stē\
electronic	 \i-ˌlek-ˈträ-nik\
element	 \ˈe-lə-mənt\
elevator	 \ˈe-lə-ˌvā-tər\
else	\ˈel(t)s\
elsewhere	 \ˈel(t)s-ˌ(h)wer\
email	\ˈē-ˌmāl\
embarrassed	 \im-ˈber-əst , -ˈba-rəst\
emerge	\i-ˈmərj\
emergency	 \i-ˈmər-jən(t)-sē\
emotion	 \i-ˈmō-shən\
emotional	 \i-ˈmō-shnəl , -shə-nᵊl\
emphasis	 \ˈem(p)-fə-səs\
emphasize	 \ˈem(p)-fə-ˌsīz\
empire	 \ˈem-ˌpī(-ə)r\
employ	 \im-ˈplȯi , em-\
employee	 \im-ˌplȯ(i)-ˈē , (ˌ)em-; im-ˈplȯ(i)-ˌē, em-\
employer	 \im-ˈplȯi-ər , em-\
employment	 \im-ˈplȯi-mənt\
empty	 \ˈem(p)-tē\
enable	 \i-ˈnā-bəl\
encounter	 \in-ˈkau̇n-tər , en-\
encourage	 \in-ˈkər-ij , -ˈkə-rij, en-\
encouraging	 \in-ˈkər-i-jiŋ , -ˈkə-ri-, en-\
end	\ˈend\
enemy	 \ˈe-nə-mē\
energy	 \ˈe-nər-jē\
engage	 \in-ˈgāj , en-\
engine	 \ˈen-jən\
engineer	 \ˌen-jə-ˈnir\
engineering	 \ˌen-jə-ˈnir-iŋ\
enhance	 \in-ˈhan(t)s , en-\
enjoy	 \in-ˈjȯi , en-\
enjoyable	 \in-ˈjȯi , en-\
enormous	 \i-ˈnȯr-məs , ē-\
enough	\i-ˈnəf , ē-, ə-\
enquiry	 \in-ˈkwī(-ə)r , ˈin-ˌkwī(-ə)r-ē , in-ˈkwī(-ə)r-ē; ˈin-kwə-rē, ˈiŋ-\
ensure	 \in-ˈshu̇r\
enter	 \ˈen-tər\
enterprise	 \ˈen-tər-ˌprīz , ˈen-tə-ˌprīz\
entertainment	 \ˌen-tər-ˈtān-mənt\
enthusiasm	 \in-ˈthü-zē-ˌa-zəm , en- also -ˈthyü-\
enthusiastic	 \in-ˌthü-zē-ˈa-stik , en- also -ˌthyü-\
entire	 \in-ˈtī(-ə)r , ˈen-ˌtī(-ə)r\
entirely	 \in-ˈtī(-ə)r-lē , ˈen-ˌtī(-ə)r-\
entitle	 \in-ˈtī-tᵊl , en-\
entrance	 \ˈen-trən(t)s\
entry	 \ˈen-trē\
envelope	 \ˈen-və-ˌlōp , ˈän-\
environment	 \in-ˈvī-rə(n)-mənt , -ˈvī(-ə)r(n)-\
environmental	 \in-ˈvī-rə(n)-mənt , -ˈvī(-ə)r(n)-\
equal	\ˈē-kwəl\
equally	 \ˈē-kwə-lē\
equipment	 \i-ˈkwip-mənt\
equivalent	 \i-ˈkwiv-lənt , -ˈkwi-və-\
era	\ˈer-ə , ˈe-rə, ˈir-ə\
error	 \ˈer-ər , ˈe-rər\
escape	 \i-ˈskāp , e-, dialectal ik-ˈskāp\
especially	 \i-ˈspesh-lē , -ˈspe-shə-\
essay	 \ˈe-ˌsā ; senses 2, 3 & 4 also e-ˈsā\
essential	 \i-ˈsen(t)-shəl\
essentially	 \i-ˈsench-lē , -ˈsen(t)-shə-\
establish	 \i-ˈsta-blish\
establishment	 \i-ˈsta-blish-mənt\
estate	 \i-ˈstāt\
estimate	 \ˈe-stə-ˌmāt\
ethnic	 \ˈeth-nik\
even	\ˈē-vən\
evening	 \ˈēv-niŋ\
event	\i-ˈvent\
eventually	 \i-ˈven(t)-sh(ə-)wə-lē , -ˈven-chə-lē, -chü-ə-lē\
ever	 \ˈe-vər\
every	 \ˈev-rē\
everybody	 \ˈev-rē-(ˌ)bə-dē , -ˌbä-\
everyone	 \ˈev-rē-(ˌ)wən\
everything	 \ˈev-rē-ˌthiŋ\
everywhere	 \ˈev-rē-ˌ(h)wer\
evidence	 \ˈe-və-dən(t)s , -və-ˌden(t)s\
evil	\ˈē-vəl , British often and US sometimes ˈē-(ˌ)vil\
exact	 \ig-ˈzakt\
exactly	 \ig-ˈzak-(t)lē\
exam	 \ig-ˈzam\
examination	 \ig-ˌza-mə-ˈnā-shən\
examine	 \ig-ˈza-mən\
example	 \ig-ˈzam-pəl\
excellent	 \ˈek-s(ə-)lənt\
except	 \ik-ˈsept\
exception	 \ik-ˈsep-shən\
exchange	 \iks-ˈchānj , ˈeks-ˌchānj\
excitement	 \ik-ˈsīt-mənt\
exciting	 \ik-ˈsī-tiŋ\
exclude	 \ik-ˈsklüd\
excuse	 \ik-ˈskyüz , imperatively often ˈskyüz\
executive	 \ig-ˈze-k(y)ə-tiv , -kyü-\
exercise	 \ˈek-sər-ˌsīz\
exhibition	 \ˌek-sə-ˈbi-shən\
exist	 \ig-ˈzist\
existence	 \ig-ˈzi-stən(t)s\
existing	 \ig-ˈzist\
exit	 \ˈeg-zət , ˈek-sət\
expand	 \ik-ˈspand\
expansion	 \ik-ˈspan(t)-shən\
expect	 \ik-ˈspekt\
expectation	 \ˌek-ˌspek-ˈtā-shən , ik-\
expenditure	 \ik-ˈspen-di-chər , -də-ˌchu̇r, -də-ˌt(y)u̇r\
expense	 \ik-ˈspen(t)s\
expensive	 \ik-ˈspen(t)-siv\
experience	 \ik-ˈspir-ē-ən(t)s\
experienced	 \ik-ˈspir-ē-ən(t)st\
experiment	 \ik-ˈsper-ə-mənt  also -ˈspir-\
experimental	 \ik-ˌsper-ə-ˈmen-tᵊl also -ˌspir-\
expert	 \ˈek-ˌspərt\
explain	 \ik-ˈsplān\
explanation	 \ˌek-splə-ˈnā-shən\
explore	 \ik-ˈsplȯr\
explosion	 \ik-ˈsplō-zhən\
export	 \ek-ˈspȯrt , ˈek-ˌspȯrt-\
expose	 \ik-ˈspōz\
express	 \ik-ˈspres\
expression	 \ik-ˈspre-shən\
extend	 \ik-ˈstend\
extension	 \ik-ˈsten(t)-shən\
extensive	 \ik-ˈsten(t)-siv\
extent	 \ik-ˈstent\
external	 \ek-ˈstər-nᵊl\
extra	 \ˈek-strə\
extraordinary	 \ik-ˈstrȯr-də-ˌner-ē , ˌek-strə-ˈȯr-\
extreme	 \ik-ˈstrēm\
extremely	 \ik-ˈstrēm-lē\
eye	\ˈī\
face	\ˈfās\
facility	 \fə-ˈsi-lə-tē\
fact	\ˈfakt\
factor	 \ˈfak-tər\
factory	 \ˈfak-t(ə-)rē\
fail	\ˈfāl\
failure	 \ˈfāl-yər\
fair	\ˈfer\
fairly	 \ˈfer-lē\
faith	\ˈfāth\
fall	\ˈfȯl\
false	\ˈfȯls\
familiar	 \fə-ˈmil-yər\
family	 \ˈfam-lē , ˈfa-mə-\
famous	 \ˈfā-məs\
fan	\ˈfan\
fancy	 \ˈfan(t)-sē\
fantastic	 \fan-ˈta-stik , fən-\
far	\ˈfär\
farm	\ˈfärm\
farmer	 \ˈfär-mər\
fascinating	 \ˈfas-ˌnā-tiŋ , ˈfa-sə-ˌnā-\
fashion	 \ˈfa-shən\
fast	\ˈfast\
fat	\ˈfat\
father	 \ˈfä-t͟hər\
fault	\ˈfȯlt , in poetry also ˈfȯt\
fear	\ˈfir\
feature	 \ˈfē-chər\
federal	 \ˈfe-d(ə-)rəl\
fee	\ˈfē\
feed	\ˈfēd\
feedback	 \ˈfēd-ˌbak\
feel	\ˈfēl\
feeling	 \ˈfē-liŋ\
fellow	 \ˈfe-(ˌ)lō\
female	 \ˈfē-ˌmāl\
fence	\ˈfen(t)s\
festival	 \ˈfe-stə-vəl\
fetch	\ˈfech\
few	\ˈfyü\
field	\ˈfēld\
fight	\ˈfīt\
figure	 \ˈfi-gyər , British and often US ˈfi-gər\
file	\ˈfī(-ə)l\
fill	\ˈfil\
film	\ˈfilm , Southern also ˈfi(ə)m\
filthy	\ˈfil-thē\
final	 \ˈfī-nᵊl\
finally	 \ˈfī-nᵊl-ē , ˈfīn-lē\
finance	 \fə-ˈnan(t)s , ˈfī-ˌnan(t)s, fī-ˈnan(t)s\
financial	 \fə-ˈnan(t)-shəl , fī-\
find	\ˈfīnd\
finding	 \ˈfīn-diŋ\
fine	\ˈfīn\
finger	 \ˈfiŋ-gər\
finish	 \ˈfi-nish\
fire	\ˈfī(-ə)r\
firm	\ˈfərm\
first	\ˈfərst\
firstly	 \ˈfərst-lē\
fish	\ˈfish\
fishing	 \ˈfi-shiŋ\
fit	\ˈfit\
fix	\ˈfiks\
fixed	\ˈfikst\
flash	\ˈflash\
flat	\ˈflat\
flesh	\ˈflesh\
flight	\ˈflīt\
flood	\ˈfləd\
floor	\ˈflȯr\
flow	\ˈflō\
flower	 \ˈflau̇(-ə)r\
fly	\ˈflī\
focus	 \ˈfō-kəs\
fold	\ˈfōld\
folk	\ˈfōk\
follow	 \ˈfä-(ˌ)lō\
following	 \ˈfä-lə-wiŋ\
food	\ˈfüd\
foot	\ˈfu̇t\
football	 \ˈfu̇t-ˌbȯl\
for	\fər, (ˈ)fȯr , Southern also (ˈ)fär\
force	\ˈfȯrs\
foreign	 \ˈfȯr-ən , ˈfär-\
forest	 \ˈfȯr-əst , ˈfär-\
forever	 \fə-ˈre-vər , fȯ-; Southern often fə-ˈe-və\
forget	 \fər-ˈget , fȯr-\
forgive	 \fər-ˈgiv , fȯr-\
fork	\ˈfȯrk\
form	\ˈfȯrm\
formal	 \ˈfȯr-məl\
formally	 \ˈfȯr-məl\
formation	 \fȯr-ˈmā-shən\
former	 \ˈfȯr-mər\
formula	 \ˈfȯr-myə-lə\
forth	\ˈfȯrth\
fortnight	 \ˈfȯrt-ˌnīt\
fortunate	 \ˈfȯrch-nət , ˈfȯr-chə-\
fortune	 \ˈfȯr-chən\
forward	 \ˈfȯr-wərd  also ˈfō- or ˈfȯ-, Southern also ˈfär-\
foundation	 \fau̇n-ˈdā-shən\
frame	\ˈfrām\
frankly	 \ˈfraŋ-klē\
free	\ˈfrē\
freedom	 \ˈfrē-dəm\
freeway	 \ˈfrē-ˌwā\
freeze	\ˈfrēz\
freezer	 \ˈfrē-zər\
frequent	 \frē-ˈkwent , ˈfrē-kwənt\
frequently	 \ˈfrē-kwənt-lē\
fresh	\ˈfresh\
fridge	\ˈfrij\
friend	\ˈfrend\
friendly	 \ˈfren(d)-lē\
friendship	 \ˈfren(d)-ˌship\
frightened	 \ˈfrī-tᵊnd\
from	\ˈfrəm , ˈfräm also fəm\
front	\ˈfrənt\
fruit	\ˈfrüt\
fry	\ˈfrī\
fuel	 \ˈfyü(-ə)l\
fulfil	 \fu̇(l)-ˈfil also fə(l)-\
full	\ˈfu̇l also ˈfəl\
fully	 \ˈfu̇(l)-lē\
fun	\ˈfən\
function	 \ˈfəŋ(k)-shən\
fund	\ˈfənd\
fundamental	 \ˌfən-də-ˈmen-tᵊl\
funeral	 \ˈfyün-rəl , ˈfyü-nə-\
funny	 \ˈfə-nē\
furniture	 \ˈfər-ni-chər\
further	 \ˈfər-t͟hər\
fuss	\ˈfəs\
future	 \ˈfyü-chər\
gain	\ˈgān\
gallery	 \ˈga-lə-rē , ˈgal-rē\
game	\ˈgām\
gang	\ˈgaŋ\
gap	\ˈgap\
garage	 \gə-ˈräzh , -ˈräj; Canadian also -ˈrazh, -ˈraj; British usually ˈga-(ˌ)räzh, -(ˌ)räj, -rij\
garbage	 \ˈgär-bij\
garden	 \ˈgär-dᵊn\
garlic	 \ˈgär-lik\
gas	\ˈgas\
gasoline	 \ˈga-sə-ˌlēn , ˌga-sə-ˈ also -zə-\
gate	\ˈgāt\
gather	 \ˈga-t͟hər also ˈge-\
gay	\ˈgā\
gear	\ˈgir\
gene	\ˈjēn\
general	 \ˈjen-rəl , ˈje-nə-\
generally	 \ˈjen-rə-lē , ˈje-nə-, ˈje-nər-lē\
generate	 \ˈje-nə-ˌrāt\
generation	 \ˌje-nə-ˈrā-shən\
generous	 \ˈjen-rəs , ˈje-nə-\
gentle	 \ˈjen-tᵊl\
gentleman	 \ˈjen-tᵊl-mən , ˈje-nᵊl-, in rapid speech also ˈjen-tə-mən, ˈje-nə-\
gently	 \ˈjen-tᵊl\
genuine	 \ˈjen-yə-wən , -(ˌ)win, nonstandard -ˌwīn\
get	\ˈget , nonstandard ˈgit\
giant	 \ˈjī-ənt\
gift	\ˈgift\
girl	\ˈgər(-ə)l\
girlfriend	 \ˈgər(-ə)l-ˌfrend\
give	\ˈgiv\
glad	\ˈglad\
glance	\ˈglan(t)s\
glass	\ˈglas , ˈgläs\
global	 \ˈglō-bəl\
glove	\ˈgləv\
go	\ˈgō\
goal	\ˈgōl , chiefly Northern US especially in senses 3b and 2a also ˈgül\
god	\ˈgäd also ˈgȯd\
gold	\ˈgōld\
golden	 \ˈgōl-dən\
golf	\ˈgälf , ˈgȯlf, ˈgäf, ˈgȯf, sometimes ˈgəlf\
good	\ˈgu̇d\
goodbye	 \gu̇d-ˈbī , gə(d)-\
goodness	 \ˈgu̇d-nəs\
goods	\ˈgu̇d\
gorgeous	 \ˈgȯr-jəs\
gosh	\ˈgäsh , ˈgȯsh\
govern	 \ˈgə-vərn\
government	 \ˈgə-vər(n)-mənt , -və-mənt; ˈgə-bᵊm-ənt, -vᵊm-\
governor	 \ˈgə-vᵊn-ər also ˈgə-vər-nər\
grab	\ˈgrab\
grade	\ˈgrād\
gradually	 \ˈgra-jə-wəl , -jəl, ˈgraj-wəl\
gram	\ˈgram\
grammar	 \ˈgra-mər\
grand	\ˈgrand\
grandad	 \ˈgran-ˌdad\
grandfather	 \ˈgran(d)-ˌfä-t͟hər\
grandma	 \ˈgran(d)-ˌmä , -ˌmȯ; ˈgra-ˌmä, -ˌmȯ\
grandmother	 \ˈgran(d)-ˌmə-t͟hər\
grandpa	 \ˈgran(d)-ˌpä , -ˌpȯ; ˈgram-ˌpä, -ˌpȯ\
granny	 \ˈgra-nē\
grant	\ˈgrant\
graph	\ˈgraf\
grass	\ˈgras\
grateful	 \ˈgrāt-fəl\
great	\ˈgrāt , Southern also ˈgre(ə)t\
greatly	 \ˈgrāt-lē\
green	\ˈgrēn\
grey	\ˈgrā\
grocery	 \ˈgrōs-rē , ˈgrō-sə-; ˈgrōsh-rē\
gross	\ˈgrōs\
ground	\ˈgrau̇nd\
group	\ˈgrüp\
grow	\ˈgrō\
growth	\ˈgrōth\
guarantee	 \ˌger-ən-ˈtē , ˌgär-, ˌga-rən- also ˈger-ən-ˌtē or ˈgär-ən-, ˈga-rən-\
guard	\ˈgärd\
guess	\ˈges\
guest	\ˈgest\
guidance	 \ˈgī-dᵊn(t)s\
guide	\ˈgīd\
guilty	\ˈgil-tē\
guitar	 \gə-ˈtär , gi-, especially Southern and Midland US also ˈgi-ˌtär\
gun	\ˈgən\
guy	\ˈgī\
habit	 \ˈha-bət\
hair	\ˈher\
half	\ˈhaf , ˈhäf\
halfway	 \ˈhaf-ˈwā , ˈhäf-\
hall	\ˈhȯl\
hand	\ˈhand\
handbag	 \ˈhan(d)-ˌbag\
handle	 \ˈhan-dᵊl\
handy	\ˈhan-dē\
hang	\ˈhaŋ\
happen	 \ˈha-pən , -pᵊm\
happy	 \ˈha-pē\
hard	\ˈhärd\
hardly	 \ˈhärd-lē\
harm	\ˈhärm\
hat	\ˈhat\
hate	\ˈhāt\
have	\ˈhav , (h)əv, v; in "have to" meaning "must" usually ˈhaf\
he	\ˈhē , ē\
head	\ˈhed\
headquarters	 \ˈhed-ˌkwȯ(r)-tərz , -ˌkȯr-, (ˈ)hed-ˈkwȯ(r), -ˈkȯr-\
health	\ˈhelth also ˈheltth\
healthy	\ˈhel-thē  also ˈhelt-\
hear	\ˈhir\
hearing	 \ˈhir-iŋ\
heart	\ˈhärt\
heat	\ˈhēt\
heater	 \ˈhē-tər\
heating	\ˈhēt\
heaven	 \ˈhe-vən\
heavily	 \ˈhe-və-lē\
heavy	\ˈhe-vē\
height	\ˈhīt , nonstandard ˈhītth\
hell	\ˈhel\
hello	 \hə-ˈlō , he-\
help	\ˈhelp ; Southern often ˈhep also ˈheəp\
helpful	 \ˈhelp-fəl ; Southern often ˈhep- also ˈheəp-\
hence	\ˈhen(t)s\
her	\(h)ər, ˈhər\
here	\ˈhir\
hero	 \ˈhir-(ˌ)ō\
hers	\ˈhərz\
herself	 \(h)ər-ˈself , Southern also -ˈsef\
hesitate	 \ˈhe-zə-ˌtāt\
hi	\ˈhī(-ē)\
hide	\ˈhīd\
high	\ˈhī\
highlight	 \ˈhī-ˌlīt\
highly	 \ˈhī-lē\
highway	 \ˈhī-ˌwā\
hill	\ˈhil\
him	\im, ˈhim\
himself	 \(h)im-ˈself , Southern also -ˈsef\
hire	\ˈhī(-ə)r\
his	\(h)iz, ˌhiz\
historian	 \hi-ˈstȯr-ē-ən , -ˈstär-\
historical	 \hi-ˈstȯr-i-kəl , -ˈstär-\
history	 \ˈhi-st(ə-)rē\
hit	\ˈhit\
hold	\ˈhōld\
holder	 \ˈhōl-dər\
holding	 \ˈhōl-diŋ\
hole	\ˈhōl\
holiday	 \ˈhä-lə-ˌdā , British usually ˈhä-lə-dē\
holy	 \ˈhō-lē\
home	\ˈhōm\
homework	 \ˈhōm-ˌwərk\
honest	 \ˈä-nəst\
honestly	 \ˈä-nəst-lē\
honey	 \ˈhə-nē\
hook	\ˈhu̇k\
hope	\ˈhōp\
hopefully	 \ˈhōp-fə-lē\
hopeless	 \ˈhō-pləs\
horrible	 \ˈhȯr-ə-bəl , ˈhär-\
horror	 \ˈhȯr-ər , ˈhär-\
horse	\ˈhȯrs\
hospital	 \ˈhä-(ˌ)spi-tᵊl\
host	\ˈhōst\
hot	\ˈhät\
hotel	 \hō-ˈtel , ˈhō-ˌtel\
hour	\ˈau̇(-ə)r\
house	\ˈhau̇s\
household	 \ˈhau̇s-ˌhōld , ˈhau̇-ˌsōld\
housing	 \ˈhau̇-ziŋ\
how	\ˈhau̇\
however	 \hau̇-ˈe-vər\
huge	\ˈhyüj , ˈyüj\
human	 \ˈhyü-mən , ˈyü-\
hungry	 \ˈhəŋ-grē\
hunt	\ˈhənt\
hurry	 \ˈhər-ē , ˈhə-rē\
hurt	\ˈhərt\
husband	 \ˈhəz-bənd\
ice	\ˈīs\
idea	\ī-ˈdē-ə , -ˈdēə also ˈī-(ˌ)dē-ə or ˈī-dē\
ideal	 \ī-ˈdē(-ə)l , ˈī-ˌdē(-ə)l\
ideally	 \ī-ˈdē-ə-lē , -ˈdē(-ə)l-lē\
identify	 \ī-ˈden-tə-ˌfī , ə-\
identity	 \ī-ˈden-tə-tē , ə-, -ˈde-nə-\
idiot	 \ˈi-dē-ət\
if	\ˈif , əf\
ignore	 \ig-ˈnȯr\
ill	\ˈil\
illegal	 \(ˌ)i(l)-ˈlē-gəl\
illness	 \ˈil-nəs\
illustrate	 \ˈi-lə-ˌstrāt also i-ˈlə-\
image	 \ˈi-mij\
imagination	 \i-ˌma-jə-ˈnā-shən\
imagine	 \i-ˈma-jən\
immediate	 \i-ˈmē-dē-ət , British often -ˈmē-jit\
immediately	 \i-ˈmē-dē-ət-lē also -ˈmē-dit- , British often -ˈmē-jit-\
impact	 \im-ˈpakt\
implement	 \ˈim-plə-mənt\
implication	 \ˌim-plə-ˈkā-shən\
imply	 \im-ˈplī\
import	 \im-ˈpȯrt , ˈim-ˌpȯrt\
importance	 \im-ˈpȯr-tᵊn(t)s , especially Southern US and New England -tən(t)s, -dən(t)s\
important	 \im-ˈpȯr-tᵊnt , especially Southern US and New England -tənt, -dənt\
impose	 \im-ˈpōz\
impossible	 \(ˌ)im-ˈpä-sə-bəl\
impress	 \im-ˈpres\
impression	 \im-ˈpre-shən\
impressive	 \im-ˈpre-siv\
improve	 \im-ˈprüv\
improvement	 \im-ˈprüv-mənt\
in	\ˈin , ən, ᵊn\
inch	\ˈinch\
incident	 \ˈin(t)-sə-dənt , -ˌdent\
include	 \in-ˈklüd\
including	 \in-ˈklüd\
income	 \ˈin-ˌkəm also ˈin-kəm or ˈiŋ-kəm\
incorporate	 \in-ˈkȯr-pə-ˌrāt\
increase	 \in-ˈkrēs , ˈin-ˌkrēs\
increasingly	 \in-ˈkrē-siŋ-lē , ˈin-ˌkrē-\
incredible	 \(ˌ)in-ˈkre-də-bəl\
incredibly	 \(ˌ)in-ˈkre-də-blē\
indeed	 \in-ˈdēd\
independence	 \ˌin-də-ˈpen-dən(t)s\
independent	 \ˌin-də-ˈpen-dənt\
index	 \ˈin-ˌdeks\
indicate	 \ˈin-də-ˌkāt\
indication	 \ˌin-də-ˈkā-shən\
individual	 \ˌin-də-ˈvij-wəl , -ˈvi-jə-wəl, -ˈvi-jəl, -ˈvi-jü-əl\
industrial	 \in-ˈdə-strē-əl\
industry	 \ˈin-(ˌ)də-strē\
inevitable	 \i-ˈne-və-tə-bəl\
inevitably	 \i-ˈne-və-tə-blē\
infant	 \ˈin-fənt\
infection	 \in-ˈfek-shən\
inflation	 \in-ˈflā-shən\
influence	 \ˈin-ˌflü-ən(t)s , especially Southern in-ˈflü-\
inform	 \in-ˈfȯrm\
informal	 \(ˌ)in-ˈfȯr-məl\
information	 \ˌin-fər-ˈmā-shən\
initial	 \i-ˈni-shəl\
initially	 \i-ˈni-sh(ə-)lē\
initiative	 \i-ˈni-shə-tiv also -shē-ə-tiv\
injure	 \ˈin-jər\
injury	 \ˈinj-rē , ˈin-jə-\
inner	 \ˈi-nər\
innocent	 \ˈi-nə-sənt\
innovation	 \ˌi-nə-ˈvā-shən\
input	 \ˈin-ˌpu̇t\
inquiry	 \in-ˈkwī(-ə)r-ē , ˈin-ˌ; ˈin-kwə-rē, ˈiŋ-; ˈin-ˌkwir-ē\
insect	 \ˈin-ˌsekt\
inside	 \(ˌ)in-ˈsīd , ˈin-ˌsīd\
insist	 \in-ˈsist\
inspection	 \in-ˈspek-shən\
inspector	 \in-ˈspek-tər\
install	 \in-ˈstȯl\
instance	 \ˈin(t)-stən(t)s\
instant	 \ˈin(t)-stənt\
instead	 \in-ˈsted\
institute	 \ˈin(t)-stə-ˌtüt , -ˌtyüt\
institution	 \ˌin(t)-stə-ˈtü-shən , -ˈtyü-\
instruction	 \in-ˈstrək-shən\
instrument	 \ˈin(t)-strə-mənt\
insurance	 \in-ˈshu̇r-ən(t)s , -ˈshər- also ˈin-ˌshu̇r-, -ˌshər-\
intellectual	 \ˌin-tə-ˈlek-chə-wəl , -chəl, -shwəl, -chü(-ə)l\
intelligence	 \in-ˈte-lə-jən(t)s\
intelligent	 \in-ˈte-lə-jənt\
intend	 \in-ˈtend\
intense	 \in-ˈten(t)s\
intention	 \in-ˈten(t)-shən\
interaction	 \ˌin-tər-ˈak-shən\
interest	 \ˈin-t(ə-)rəst ; ˈin-tə-ˌrest, -ˌtrest; ˈin-tərst\
interested	 \ˈin-t(ə-)rə-stəd ; ˈin-tə-ˌre-, ˈin-ˌtre-; ˈin-tər-\
interesting	 \ˈin-t(ə-)rə-stiŋ ; ˈin-tə-ˌre-, ˈin-ˌtre-; ˈin-tər-\
internal	 \in-ˈtər-nᵊl , ˈin-ˌtər-\
international	 \ˌin-tər-ˈnash-nəl , -ˈna-shə-nᵊl\
internet	 \ˈin-tər-ˌnet\
interpret	 \in-ˈtər-prət , -pət\
interpretation	 \in-ˌtər-prə-ˈtā-shən , -pə-\
interval	 \ˈin-tər-vəl\
intervention	 \ˌin-tər-ˈven(t)-shən\
interview	 \ˈin-tər-ˌvyü\
into	 \ˈin-(ˌ)tü , -tə\
introduce	 \ˌin-trə-ˈdüs , -ˈdyüs\
introduction	 \ˌin-trə-ˈdək-shən\
invest	 \in-ˈvest\
investigate	 \in-ˈve-stə-ˌgāt\
investigation	 \in-ˈve-stə-ˌgāt\
investment	 \in-ˈves(t)-mənt\
invite	 \in-ˈvīt\
involve	 \in-ˈvälv , -ˈvȯlv also -ˈväv or -ˈvȯv\
involved	 \in-ˈvälvd , -ˈvȯlvd also -ˈvävd or -ˈvȯvd\
involvement	 \in-ˈvälv-mənt , -ˈvȯlv-\
iron	\ˈī(-ə)rn\
island	 \ˈī-lənd\
issue	 \ˈi-(ˌ)shü , chiefly Southern ˈi-shə, chiefly British ˈis-(ˌ)yü\
it	\ˈit , ət\
item	\ˈī-təm\
its	\ˈits , əts\
itself	 \it-ˈself , ət-, Southern also -ˈsef\
jacket	 \ˈja-kət\
jam	\ˈjam\
job	\ˈjäb\
join	\ˈjȯin\
joint	\ˈjȯint\
joke	\ˈjōk\
journalist	 \ˈjər-nə-list\
journey	 \ˈjər-nē\
joy	\ˈjȯi\
judge	\ˈjəj\
judgment	 \ˈjəj-mənt\
juice	\ˈjüs\
jump	\ˈjəmp\
jumper	 \ˈjəm-pər\
junior	 \ˈjün-yər\
jury	 \ˈju̇r-ē , ˈjər-\
just	\ˈjəst\
justice	 \ˈjə-stəs\
justify	 \ˈjə-stə-ˌfī\
keen	\ˈkēn\
keep	\ˈkēp\
kettle	 \ˈke-tᵊl\
key	\ˈkē\
keyboard	 \ˈkē-ˌbȯrd\
kick	\ˈkik\
kid	\ˈkid\
kill	\ˈkil\
kilometre	 \kə-ˈlä-mə-tər , ki-; ˈki-lə-ˌmē-tər\
kind	\ˈkīnd\
king	\ˈkiŋ\
kiss	\ˈkis\
kit	\ˈkit\
kitchen	 \ˈki-chən\
knee	\ˈnē\
knife	\ˈnīf\
knock	\ˈnäk\
know	\ˈnō\
knowledge	 \ˈnä-lij\
known	\ˈnōn\
lab	\ˈlab\
label	 \ˈlā-bəl\
laboratory	 \ˈla-b(ə-)rə-ˌtȯr-ē , sometimes ˈla-bər-ˌtȯr- or ˈla-bə-ˌtȯr- or lə-ˈbȯr-ə-ˌtȯr-, British usually lə-ˈbär-ə-t(ə-)rē\
lack	\ˈlak\
lad	\ˈlad\
ladder	 \ˈla-dər\
lady	 \ˈlā-dē\
lake	\ˈlāk\
lamb	\ˈlam\
lamp	\ˈlamp\
land	\ˈland\
landlord	 \ˈland-ˌlȯrd\
landscape	 \ˈlan(d)-ˌskāp\
lane	\ˈlān\
language	 \ˈlaŋ-gwij , -wij\
large	\ˈlärj\
largely	 \ˈlärj-lē\
last	\ˈlast\
late	\ˈlāt\
later	 \ˈlā-tər\
latter	 \ˈla-tər\
laugh	\ˈlaf , ˈläf\
launch	\ˈlȯnch , ˈlänch\
law	\ˈlȯ\
lawyer	 \ˈlȯ-yər , ˈlȯi-ər\
lay	\ˈlā\
layer	 \ˈlā-ər , ˈler\
lazy	 \ˈlā-zē\
lead	\ˈlēd\
leader	 \ˈlē-dər\
leadership	 \ˈlē-dər-ˌship\
leading	 \ˈlē-diŋ\
leaf	\ˈlēf\
league	\ˈlēg\
lean	\ˈlēn\
learn	\ˈlərn\
least	\ˈlēst\
leather	 \ˈle-t͟hər\
leave	\ˈlēv\
lecture	 \ˈlek-chər , -shər\
left	\ˈleft\
leg	\ˈleg  also ˈlāg\
legal	 \ˈlē-gəl\
legislation	 \ˌle-jə-ˈslā-shən\
leisure	 \ˈlē-zhər , ˈle-, ˈlā-\
lend	\ˈlend\
length	\ˈleŋ(k)th , ˈlen(t)th\
less	\ˈles\
lesson	 \ˈle-sᵊn\
let	\ˈlet\
letter	 \ˈle-tər\
level	 \ˈle-vəl\
liberal	 \ˈli-b(ə-)rəl\
library	 \ˈlī-ˌbrer-ē , -ˌbre-rē; British usually and US sometimes -brə-rē; British often and US sometimes -brē, nonstandard -ˌber-ē, nonstandard -ˌbe-rē\
licence	 \ˈlī-sᵊn(t)s\
lick	\ˈlik\
lid	\ˈlid\
lie	\ˈlī\
life	\ˈlīf\
lift	\ˈlift\
light	\ˈlīt\
lighting	 \ˈlī-tiŋ\
like	\ˈlīk\
likely	 \ˈlī-klē\
limit	 \ˈli-mət\
limitation	 \ˌli-mə-ˈtā-shən\
limited	 \ˈli-mə-təd\
line	\ˈlīn\
link	\ˈliŋk\
lip	\ˈlip\
liquid	 \ˈli-kwəd\
list	\ˈlist\
listen	 \ˈli-sᵊn\
literally	 \ˈli-tə-rə-lē , ˈli-trə-lē, ˈli-tər-lē\
literary	 \ˈli-tə-ˌrer-ē\
literature	 \ˈli-tə-rə-ˌchu̇r , ˈli-trə-ˌchu̇r, ˈli-tər-ˌchu̇r, ˈli-tə-, -chər, -ˌtyu̇r, -ˌtu̇r\
little	 \ˈli-tᵊl\
live	\ˈliv\
lively	 \ˈlīv-lē\
living	 \ˈli-viŋ\
load	\ˈlōd\
loan	\ˈlōn\
local	 \ˈlō-kəl\
locate	 \ˈlō-ˌkāt , lō-ˈkāt\
location	 \lō-ˈkā-shən\
lock	\ˈläk\
log	\ˈlȯg , ˈläg\
logical	 \ˈlä-ji-kəl\
lonely	 \ˈlōn-lē\
long	\ˈlȯŋ\
long-term	\ˈlȯŋ-ˈtərm\
look	\ˈlu̇k\
loose	\ˈlüs\
lord	\ˈlȯrd\
lorry	 \ˈlȯr-ē , ˈlär-\
lose	\ˈlüz\
loss	\ˈlȯs\
lost	\ˈlȯst\
lot	\ˈlät\
loud	\ˈlau̇d\
lounge	\ˈlau̇nj\
love	\ˈləv\
lovely	 \ˈləv-lē\
lover	 \ˈlə-vər\
low	\ˈlō\
lower	 \ˈlau̇(-ə)r , ˈlō-ər\
luck	\ˈlək\
luckily	 \ˈlə-kə-lē\
lucky	\ˈlə-kē\
lump	\ˈləmp\
lunch	\ˈlənch\
lunchtime	 \ˈlənch-ˌtīm\
machine	 \mə-ˈshēn\
machinery	 \mə-ˈshē-nə-rē , -ˈshēn-rē\
mad	\ˈmad\
madam	 \ˈma-dəm\
magazine	 \ˈma-gə-ˌzēn , ˌma-gə-ˈzēn\
magic	 \ˈma-jik\
mail	\ˈmāl\
main	\ˈmān\
mainly	 \ˈmān-lē\
maintain	 \mān-ˈtān , mən-\
maintenance	 \ˈmānt-nən(t)s , ˈmān-tə-nən(t)s\
major	 \ˈmā-jər\
majority	 \mə-ˈjȯr-ə-tē , -ˈjär-\
make	\ˈmāk\
male	\ˈmāl\
mall	\ˈmȯl , especially British and for sense 1 ˈmal\
man	\ˈman , in compounds ˌman or mən\
manage	 \ˈma-nij\
management	 \ˈma-nij-mənt\
manager	 \ˈma-ni-jər\
manner	 \ˈma-nər\
manufacturer	 \ˌman-yə-ˈfak-chər-ər , -ˈfak-shrər, ˌma-nə-\
manufacturing	 \ˌman-yə-ˈfak-chər , ˌma-nə-\
many	\ˈme-nē\
map	\ˈmap\
march	\ˈmärch\
margin	 \ˈmär-jən\
mark	\ˈmärk\
market	 \ˈmär-kət\
marketing	 \ˈmär-kə-tiŋ\
marriage	 \ˈmer-ij , ˈma-rij\
married	 \ˈmer-ēd , ˈma-rēd\
marry	 \ˈmer-ē , ˈma-rē\
marvellous	 \ˈmärv-(ə-)ləs\
mass	\ˈmas\
massive	 \ˈma-siv\
master	 \ˈma-stər\
match	\ˈmach\
mate	\ˈmāt\
material	 \mə-ˈtir-ē-əl\
math	\ˈmath\
maths	\ˈmaths\
matter	 \ˈma-tər\
maximum	 \ˈmak-s(ə-)məm\
may	\ˈmā\
maybe	 \ˈmā-bē  also ˈme-\
me	\ˈmē\
meal	\ˈmēl\
mean	\ˈmēn\
meaning	 \ˈmē-niŋ\
means	\ˈmēn\
meanwhile	 \ˈmēn-ˌhwī(-ə)l , -ˌwī(-ə)l\
measure	 \ˈme-zhər , ˈmā-\
measurement	 \ˈme-zhər-mənt , ˈmā-\
meat	\ˈmēt\
mechanism	 \ˈme-kə-ˌni-zəm\
media	 \ˈmē-dē-ə\
medical	 \ˈme-di-kəl\
medicine	 \ˈme-di-sən , British usually ˈmed-sən\
medieval	 \ˌmē-ˈdē-vəl , mi-, ˌme-, -dē-ˈē-vəl\
medium	 \ˈmē-dē-əm\
meet	\ˈmēt\
meeting	 \ˈmē-tiŋ\
member	 \ˈmem-bər\
membership	 \ˈmem-bər-ˌship\
memory	 \ˈmem-rē , ˈme-mə-\
mental	 \ˈmen-tᵊl\
mention	 \ˈmen(t)-shən\
menu	\ˈmen-(ˌ)yü , ˈmān-\
mere	\ˈmir\
merely	 \ˈmir-lē\
mess	\ˈmes\
message	 \ˈme-sij\
messy	\ˈme-sē\
metal	 \ˈme-tᵊl\
method	 \ˈme-thəd\
metre	 \ˈmē-tər\
middle	 \ˈmi-dᵊl\
midnight	 \ˈmid-ˌnīt\
might	\ˈmīt\
mile	\ˈmī(-ə)l\
military	 \ˈmi-lə-ˌter-ē\
milk	\ˈmilk\
millimetre	 \ˈmi-lə-ˌmē-tər\
mind	\ˈmīnd\
mine	\ˈmīn\
mineral	 \ˈmin-rəl, ˈmi-nə-\
minimum	 \ˈmi-nə-məm\
minister	 \ˈmi-nə-stər\
ministry	 \ˈmi-nə-strē\
minor	 \ˈmī-nər\
minority	 \mə-ˈnȯr-ə-tē , mī-, -ˈnär-\
minute	 \ˈmi-nət\
mirror	 \ˈmir-ər , ˈmi-rər\
misery	 \ˈmi-zə-rē , ˈmiz-rē\
miss	\ˈmis\
mission	 \ˈmi-shən\
mistake	 \mə-ˈstāk\
mix	\ˈmiks\
mixed	\ˈmikst\
mixture	 \ˈmiks-chər\
mobile	 \ˈmō-bəl , -ˌbī-əl  also -ˌbēl\
mode	\ˈmōd\
model	 \ˈmä-dᵊl\
modern	 \ˈmä-dərn , nonstandard ˈmä-d(ə-)rən\
mom	\ˈmäm , ˈməm\
moment	 \ˈmō-mənt\
mommy	 \ˈmä-mē , ˈmə-mē\
money	 \ˈmə-nē\
monitor	 \ˈmä-nə-tər\
month	\ˈmən(t)th\
mood	\ˈmüd\
moon	\ˈmün\
moral	 \ˈmȯr-əl , ˈmär-\
more	\ˈmȯr\
moreover	 \mȯr-ˈō-vər , ˈmȯr-ˌō-\
morning	 \ˈmȯr-niŋ\
mortgage	 \ˈmȯr-gij\
most	\ˈmōst\
mostly	 \ˈmōst-lē\
mother	 \ˈmə-t͟hər\
motion	 \ˈmō-shən\
motor	 \ˈmō-tər\
motorway	 \ˈmō-tər-ˌwā\
mountain	 \ˈmau̇n-tᵊn\
mouse	\ˈmau̇s\
mouth	\ˈmau̇th\
move	\ˈmüv\
movement	 \ˈmüv-mənt\
movie	 \ˈmü-vē\
much	\ˈməch\
mud	\ˈməd\
mum	\ˈməm\
mummy	 \ˈmə-mē\
murder	 \ˈmər-dər\
muscle	 \ˈmə-səl\
museum	 \myu̇-ˈzē-əm\
mushroom	 \ˈməsh-ˌrüm , -ˌru̇m; chiefly Northern and Midland US -ˌrün; dialectal ˈmə-shə-ˌrüm, -ˌru̇m, -ˌrün\
music	 \ˈmyü-zik\
musical	 \ˈmyü-zi-kəl\
must	\məs(t), ˈməst\
my	\ˈmī , mə\
myself	 \mī-ˈself , mə-, Southern also -ˈsef\
mystery	 \ˈmi-st(ə-)rē\
nail	\ˈnāl\
naked	 \ˈnā-kəd , especially Southern ˈne-kəd\
name	\ˈnām\
narrow	 \ˈner-(ˌ)ō , ˈna-(ˌ)rō\
nasty	 \ˈna-stē\
nation	 \ˈnā-shən\
national	 \ˈnash-nəl , ˈna-shə-nᵊl\
native	 \ˈnā-tiv\
natural	 \ˈna-chə-rəl , ˈnach-rəl\
naturally	 \ˈna-chər-ə-lē , ˈnach-rə-, ˈna-chər-\
nature	 \ˈnā-chər\
naughty	 \ˈnȯ-tē , ˈnä-\
near	\ˈnir\
nearby	 \nir-ˈbī , ˈnir-ˌ\
nearly	 \ˈnir-lē\
neat	\ˈnēt\
necessarily	 \ˌne-sə-ˈser-ə-lē\
necessary	 \ˈne-sə-ˌser-ē\
neck	\ˈnek\
need	\ˈnēd\
negative	 \ˈne-gə-tiv\
negotiate	 \ni-ˈgō-shē-ˌāt , nonstandard -sē-\
negotiation	 \ni-ˌgō-shē-ˈā-shən , nonstandard -sē-\
neither	 \ˈnē-t͟hər  also ˈnī-\
nerve	\ˈnərv\
nervous	 \ˈnər-vəs\
net	\ˈnet\
network	 \ˈnet-ˌwərk\
never	 \ˈne-vər\
nevertheless	 \ˌne-vər-t͟hə-ˈles\
new	\ˈnü , chiefly British ˈnyü, in place names usually (ˌ)nu̇ or nə or (ˌ)ni\
newly	 \ˈnü-lē , ˈnyü-\
news	\ˈnüz , ˈnyüz\
newspaper	 \ˈnüz-ˌpā-pər , ˈnyüz-, ˈn(y)üs-\
next	\ˈnekst\
nice	\ˈnīs\
nicely	\ˈnīs\
night	\ˈnīt\
nil	\ˈnil\
no	\ˈnō\
nobody	 \ˈnō-(ˌ)bə-dē , -ˌbä-\
nod	\ˈnäd\
noise	\ˈnȯiz\
noisy	\ˈnȯi-zē\
none	\ˈnən\
nonsense	 \ˌnän-ˌsen(t)s , ˈnän(t)-sən(t)s\
nope	\ˈnōp  or with glottal stop instead of p\
nor	\nər, ˈnȯr , Southern also ˈnär\
normal	 \ˈnȯr-məl\
normally	 \ˈnȯr-məl\
north	\ˈnȯrth\
northern	 \ˈnȯr-t͟hərn , ˈnȯr-t͟hən\
nose	\ˈnōz\
not	\ˈnät\
notably	 \ˈnō-tə-blē\
note	\ˈnōt\
nothing	 \ˈnə-thiŋ\
notice	 \ˈnō-təs\
notion	 \ˈnō-shən\
novel	 \ˈnä-vəl\
now	\ˈnau̇\
nowadays	 \ˈnau̇-(ə-)ˌdāz\
nowhere	 \ˈnō-ˌ(h)wer , -(h)wər\
nuclear	 \ˈnü-klē-ər , ˈnyü- , nonstandard -kyə-lər\
nuisance	 \ˈnü-sᵊn(t)s , ˈnyü-\
number	 \ˈnəm-bər\
numerous	 \ˈnüm-rəs , ˈnü-mə-; ˈnyüm-, ˈnyü-mə-\
nurse	\ˈnərs\
nut	\ˈnət\
object	 \ˈäb-jikt , -(ˌ)jekt\
objection	 \əb-ˈjek-shən\
objective	 \əb-ˈjek-tiv , äb-\
obligation	 \ˌä-blə-ˈgā-shən\
observation	 \ˌäb-sər-ˈvā-shən , -zər-\
observe	 \əb-ˈzərv\
obtain	 \əb-ˈtān , äb-\
obvious	 \ˈäb-vē-əs\
obviously	 \ˈäb-vē-əs-lē\
occasion	 \ə-ˈkā-zhən\
occasional	 \ə-ˈkāzh-nəl , -ˈkā-zhə-nᵊl\
occasionally	 \ə-ˈkāzh-nə-lē , -ˈkā-zhə-nᵊl-ē\
occupation	 \ˌä-kyə-ˈpā-shən\
occupy	 \ˈä-kyə-ˌpī\
occur	 \ə-ˈkər\
ocean	\ˈō-shən\
odd	\ˈäd\
odds	\ˈädz\
of	\əv, before consonants also ə; ˈəv , ˈäv\
off	\ˈȯf\
offence	 \ə-ˈfen(t)s , especially for sense 3 ˈä-ˌfen(t)s, ˈȯ-\
offer	 \ˈȯ-fər , ˈä-\
office	 \ˈä-fəs , ˈȯ-\
officer	 \ˈä-fə-sər , ˈȯ-\
official	 \ə-ˈfi-shəl , ō-\
often	 \ˈȯ-fən , ˈȯf-tən\
oil	\ˈȯi(-ə)l\
old	\ˈōld ; for sense 9 usually ˈōl\
on	\ˈȯn , ˈän\
once	\ˈwən(t)s\
one	\ˈwən\
onion	 \ˈən-yən\
only	 \ˈōn-lē\
onto	 \ˈȯn-(ˌ)tü , ˈän-\
open	\ˈō-pən , -pᵊm\
opening	 \ˈōp-niŋ , ˈō-pə-\
operate	 \ˈä-pə-ˌrāt , ˈä-ˌprāt\
operation	 \ˌä-pə-ˈrā-shən\
operator	 \ˈä-pə-ˌrā-tər , ˈä-ˌprā-\
opinion	 \ə-ˈpin-yən\
opponent	 \ə-ˈpō-nənt\
opportunity	 \ˌä-pər-ˈtü-nə-tē , -ˈtyü-\
oppose	 \ə-ˈpōz\
opposite	 \ˈä-pə-zət , ˈäp-sət\
opposition	 \ˌä-pə-ˈzi-shən\
option	 \ˈäp-shən\
or	\ər, ˈȯr , Southern also ˈär\
orange	 \ˈär-inj , ˈär(-ə)nj; chiefly Northern & Midland ȯr-inj, ˈȯr(-ə)nj\
order	 \ˈȯr-dər\
ordinary	 \ˈȯr-də-ˌner-ē\
organ	 \ˈȯr-gən\
organic	 \ȯr-ˈga-nik\
organization	 \ˌȯr-gə-nə-ˈzā-shən , ˌȯrg-nə-\
organize	 \ˈȯr-gə-ˌnīz\
organized	 \ˈȯr-gə-ˌnīzd\
origin	 \ˈȯr-ə-jən , ˈär-\
original	 \ə-ˈri-jə-nᵊl , -ˈrij-nəl\
originally	 \ə-ˈri-jə-nᵊl-ē ; -ˈrij-nə-lē, -ˈri-jən-\
other	 \ˈə-t͟hər\
otherwise	 \ˈə-t͟hər-ˌwīz\
ought	\ˈȯt\
ounce	\ˈau̇n(t)s\
our	\är, ˈau̇(-ə)r\
ours	\ˈau̇(-ə)rz , ärz\
ourselves	 \är-ˈselvz , au̇(-ə)r-\
out	\ˈau̇t\
outcome	 \ˈau̇t-ˌkəm\
output	 \ˈau̇t-ˌpu̇t\
outside	 \ˌau̇t-ˈsīd , ˈau̇t-ˌsīd\
outstanding	 \au̇t-ˈstan-diŋ , ˈau̇t-ˌstan-\
oven	 \ˈə-vən\
over	\ˈō-vər\
overall	 \ˌō-vər-ˈȯl\
overcome	 \ˌō-vər-ˈkəm\
overseas	 \ˌō-vər-ˈsēz\
overtime	 \ˈō-vər-ˌtīm\
owe	\ˈō\
own	\ˈōn\
owner	 \ˈō-nər\
ownership	 \ˈō-nər-ˌship\
o’clock	 \ə-ˈkläk , ō-\
pace	\ˈpās\
pack	\ˈpak\
package	 \ˈpa-kij\
packet	 \ˈpa-kət\
pad	\ˈpad\
page	\ˈpāj\
pain	\ˈpān\
paint	\ˈpānt\
painting	 \ˈpān-tiŋ\
pair	\ˈper\
palace	 \ˈpa-ləs\
pale	\ˈpāl\
pan	\ˈpan\
panel	 \ˈpa-nᵊl\
panic	 \ˈpa-nik\
pants	\ˈpan(t)s\
paper	 \ˈpā-pər\
parcel	 \ˈpär-səl\
pardon	 \ˈpär-dᵊn\
parent	 \ˈper-ənt\
park	\ˈpärk\
parking	\ˈpärk\
parliament	 \ˈpär-lə-mənt  also ˈpärl-yə-\
part	\ˈpärt\
participate	 \pär-ˈti-sə-ˌpāt , pər-\
particular	 \pər-ˈti-kyə-lər , pə-, -k(ə-)lər\
particularly	 \pər-ˈti-kyə-(lər-)lē , pə-ˈti-kyə-(lər-)lē, -ˈti-kyə-lə-lē; -ˈti-k(ə-)lē ; also pär-\
partly	 \ˈpärt-lē\
partner	 \ˈpärt-nər  also ˈpärd-\
partnership	 \ˈpärt-nər-ˌship also ˈpärd-\
party	 \ˈpär-tē\
pass	\ˈpas\
passage	 \ˈpa-sij\
passenger	 \ˈpa-sᵊn-jər\
passion	 \ˈpa-shən\
past	\ˈpast\
path	\ˈpath , ˈpäth\
patience	 \ˈpā-shən(t)s\
patient	 \ˈpā-shənt\
pattern	 \ˈpa-tərn\
pause	\ˈpȯz\
pay	\ˈpā\
payment	 \ˈpā-mənt\
peace	\ˈpēs\
peaceful	 \ˈpēs-fəl\
peak	\ˈpēk\
pen	\ˈpen\
penalty	 \ˈpe-nᵊl-tē\
pencil	 \ˈpen(t)-səl\
penny	 \ˈpe-nē\
pension	 \ˈpen(t)-shən\
people	 \ˈpē-pəl\
pepper	 \ˈpe-pər\
per	\ˈpər\
perceive	 \pər-ˈsēv\
percent	 \pər-ˈsent\
percentage	 \pər-ˈsen-tij\
perception	 \pər-ˈsep-shən\
perfect	 \ˈpər-fikt\
perfectly	 \ˈpər-fik(t)-lē\
perform	 \pər-ˈfȯrm , pə-\
performance	 \pər-ˈfȯr-mən(t)s , pə-\
perhaps	 \pər-ˈhaps , ˈpraps\
period	 \ˈpir-ē-əd\
permanent	 \ˈpər-mə-nənt , ˈpərm-nənt\
permission	 \pər-ˈmi-shən\
permit	 \pər-ˈmit\
person	 \ˈpər-sᵊn\
personal	 \ˈpərs-nəl , ˈpər-sə-nəl\
personality	 \ˌpər-sə-ˈna-lə-tē , ˌpər-ˈsna-\
personally	 \ˈpərs-nə-lē , ˈpər-sə-nə-\
personnel	 \ˌpər-sə-ˈnel\
perspective	 \pər-ˈspek-tiv\
persuade	 \pər-ˈswād\
petrol	 \ˈpe-trəl , -ˌträl\
phase	\ˈfāz\
philosophy	 \fə-ˈlä-s(ə-)fē\
phone	\ˈfōn\
photo	 \ˈfō-(ˌ)tō\
photocopy	 \ˈfō-tə-ˌkä-pē\
photograph	 \ˈfō-tə-ˌgraf\
phrase	\ˈfrāz\
physical	 \ˈfi-zi-kəl\
physically	 \ˈfi-zi-k(ə-)lē\
physics	 \ˈfi-ziks\
piano	 \pē-ˈä-(ˌ)nō\
pick	\ˈpik\
picture	 \ˈpik-chər\
pie	\ˈpī\
piece	\ˈpēs\
pig	\ˈpig\
pile	\ˈpī(-ə)l\
pill	\ˈpil\
pilot	 \ˈpī-lət\
pin	\ˈpin\
pink	\ˈpiŋk\
pint	\ˈpīnt\
pipe	\ˈpīp\
pitch	\ˈpich\
pity	\ˈpi-tē\
pizza	 \ˈpēt-sə\
place	\ˈplās\
plain	\ˈplān\
plan	\ˈplan\
plane	\ˈplān\
planet	 \ˈpla-nət\
plant	\ˈplant\
plastic	 \ˈpla-stik\
plate	\ˈplāt\
platform	 \ˈplat-ˌfȯrm\
play	\ˈplā\
player	 \ˈplā-ər\
pleasant	 \ˈple-zᵊnt\
please	\ˈplēz\
pleased	\ˈplēz\
pleasure	 \ˈple-zhər , ˈplā-\
plenty	 \ˈplen-tē\
plot	\ˈplät\
plug	\ˈpləg\
plus	\ˈpləs\
pocket	 \ˈpä-kət\
poem	 \ˈpō-əm , -im, ˈpōm also ˈpȯ(-)im, ˈpō-ˌem\
poet	 \ˈpō-ət , -it also ˈpȯ(-)it\
poetry	 \ˈpō-ə-trē , -i-trē also ˈpȯ(-)i-trē\
point	\ˈpȯint\
pole	\ˈpōl\
police	 \pə-ˈlēs\
policeman	 \pə-ˈlēs-mən\
policy	 \ˈpä-lə-sē\
polite	 \pə-ˈlīt\
political	 \pə-ˈli-ti-kəl\
politician	 \ˌpä-lə-ˈti-shən\
politics	 \ˈpä-lə-ˌtiks\
poll	\ˈpōl\
pollution	 \pə-ˈlü-shən\
pond	\ˈpänd\
pool	\ˈpül\
poor	\ˈpu̇r , ˈpȯr\
pop	\ˈpäp\
popular	 \ˈpä-pyə-lər\
population	 \ˌpä-pyə-ˈlā-shən\
port	\ˈpȯrt\
pose	\ˈpōz\
position	 \pə-ˈzi-shən\
positive	 \ˈpä-zə-tiv , ˈpäz-tiv\
possess	 \pə-ˈzes  also -ˈses\
possession	 \pə-ˈze-shən also -ˈse-\
possibility	 \ˌpä-sə-ˈbi-lə-tē\
possible	 \ˈpä-sə-bəl\
possibly	 \ˈpä-sə-blē\
post	\ˈpōst\
poster	 \ˈpō-stər\
pot	\ˈpät\
potato	 \pə-ˈtā-(ˌ)tō , -tə, dialectal pə-ˈdā-, bə-\
potential	 \pə-ˈten(t)-shəl\
pound	\ˈpau̇nd\
pour	\ˈpȯr\
poverty	 \ˈpä-vər-tē\
power	 \ˈpau̇(-ə)r\
powerful	 \ˈpau̇(-ə)r-fəl\
practical	 \ˈprak-ti-kəl\
practically	 \ˈprak-ti-k(ə-)lē\
practice	 \ˈprak-təs\
practise	 \ˈprak-təs\
praise	\ˈprāz\
pray	\ˈprā\
prayer	\ˈprer\
precise	 \pri-ˈsīs\
precisely	 \pri-ˈsīs-lē\
predeterminer	 \ˌprē-di-ˈtər-mə-nər\
predict	 \pri-ˈdikt\
prefer	 \pri-ˈfər\
preference	 \ˈpre-fərn(t)s , ˈpre-f(ə-)rən(t)s\
pregnant	 \ˈpreg-nənt\
premise	 \ˈpre-məs\
preparation	 \ˌpre-pə-ˈrā-shən\
prepare	 \pri-ˈper\
prepared	 \pri-ˈperd\
presence	 \ˈpre-zᵊn(t)s\
present	 \ˈpre-zᵊnt\
presentation	 \ˌprē-ˌzen-ˈtā-shən , ˌpre-zᵊn-, ˌprē-zᵊn-\
preserve	 \pri-ˈzərv\
president	 \ˈpre-zə-dənt , ˈprez-dənt, ˈpre-zə-ˌdent, in rapid speech ˈpre-zᵊnt\
press	\ˈpres\
pressure	 \ˈpre-shər\
presumably	 \pri-ˈzü-mə-blē\
presume	 \pri-ˈzüm\
pretend	 \pri-ˈtend\
pretty	 \ˈpri-tē , ˈpər- also ˈpru̇-\
prevent	 \pri-ˈvent\
previous	 \ˈprē-vē-əs\
previously	 \ˈprē-vē-əs\
price	\ˈprīs\
pride	\ˈprīd\
priest	\ˈprēst\
primarily	 \prī-ˈmer-ə-lē also prə- , chiefly British ˈprī-mə-rə-lē\
primary	 \ˈprī-ˌmer-ē , ˈprī-mə-rē, ˈprīm-rē\
prince	\ˈprin(t)s\
princess	 \ˈprin(t)-səs , ˈprin-ˌses, (usually British) prin-ˈses\
principal	 \ˈprin(t)-s(ə-)pəl , -sə-bəl\
principle	 \ˈprin(t)-s(ə-)pəl , -sə-bəl\
print	\ˈprint\
printer	 \ˈprin-tər\
prior	 \ˈprī(-ə)r\
priority	 \prī-ˈȯr-ə-tē , -ˈär-\
prison	 \ˈpri-zᵊn\
prisoner	 \ˈpriz-nər , ˈpri-zᵊn-ər\
private	 \ˈprī-vət\
privilege	 \ˈpriv-lij , ˈpri-və-\
prize	\ˈprīz\
probably	 \ˈprä-bə-blē , ˈprä(b)-blē\
problem	 \ˈprä-bləm , -bᵊm, -ˌblem\
procedure	 \prə-ˈsē-jər\
proceed	 \prō-ˈsēd , prə-\
proceeding	 \prō-ˈsē-diŋ , prə-\
process	 \ˈprä-ˌses , ˈprō-, -səs\
produce	 \prə-ˈdüs , prō-, -ˈdyüs\
producer	 \prə-ˈdü-sər , prō-, -ˈdyü-\
product	 \ˈprä-(ˌ)dəkt\
production	 \prə-ˈdək-shən , prō-\
profession	 \prə-ˈfe-shən\
professional	 \prə-ˈfesh-nəl , -ˈfe-shə-nᵊl\
professor	 \prə-ˈfe-sər\
profile	 \ˈprō-ˌfī(-ə)l\
profit	 \ˈprä-fət\
program	 \ˈprō-ˌgram , -grəm\
progress	 \ˈprä-grəs , -ˌgres, US also and British usually ˈprō-ˌgres\
project	 \ˈprä-ˌjekt , -jikt also ˈprō-\
promise	 \ˈprä-məs\
promote	 \prə-ˈmōt\
promotion	 \prə-ˈmō-shən\
prompt	\ˈpräm(p)t\
proof	\ˈprüf\
proper	 \ˈprä-pər\
properly	 \ˈprä-pər-lē\
property	 \ˈprä-pər-tē\
proportion	 \prə-ˈpȯr-shən\
proposal	 \prə-ˈpō-zəl\
propose	 \prə-ˈpōz\
proposed	 \prə-ˈpōz\
prosecution	 \ˌprä-si-ˈkyü-shən\
prospect	 \ˈprä-ˌspekt\
protect	 \prə-ˈtekt\
protection	 \prə-ˈtek-shən\
protest	 \ˈprō-ˌtest\
proud	\ˈprau̇d\
prove	\ˈprüv\
provide	 \prə-ˈvīd\
provided	 \prə-ˈvī-dəd\
providing	 \prə-ˈvī-diŋ\
provision	 \prə-ˈvi-zhən\
psychological	 \ˌsī-kə-ˈlä-ji-kəl\
psychology	 \sī-ˈkä-lə-jē\
pub	\ˈpəb\
public	 \ˈpə-blik\
publication	 \ˌpə-blə-ˈkā-shən\
publicity	 \(ˌ)pə-ˈbli-sə-tē , -ˈbli-stē\
publish	 \ˈpə-blish\
publisher	 \ˈpə-bli-shər\
pudding	 \ˈpu̇-diŋ\
pull	\ˈpu̇l  also ˈpəl\
punch	\ˈpənch\
punishment	 \ˈpə-nish-mənt\
pupil	 \ˈpyü-pəl\
purchase	 \ˈpər-chəs\
pure	\ˈpyu̇r\
purely	 \ˈpyu̇r-lē\
purple	 \ˈpər-pəl\
purpose	 \ˈpər-pəs\
purse	\ˈpərs\
pursue	 \pər-ˈsü , -ˈsyü\
push	\ËˆpuÌ‡sh\
put	\ˈpu̇t\
qualification	 \ˌkwä-lə-fə-ˈkā-shən\
qualify	 \ˈkwä-lə-ˌfī\
quality	 \ˈkwä-lə-tē\
quantity	 \ˈkwän-tə-tē\
quarter	 \ˈkwȯ(r)-tər  also ˈkȯ(r)-\
queen	\ˈkwēn\
question	 \ˈkwes-chən , ˈkwesh-\
queue	\ˈkyü\
quick	\ˈkwik\
quickly	\ˈkwik\
quid	\ˈkwid\
quiet	 \ˈkwī-ət\
quietly	 \ˈkwī-ət\
quit	\ˈkwit\
quite	\ˈkwīt\
quote	\ˈkwōt also ˈkōt\
race	\ˈrās\
racing	 \ˈrā-siŋ\
radical	 \ˈra-di-kəl\
radio	 \ˈrā-dē-ˌō\
rail	\ˈrāl\
railway	 \ˈrāl-ˌwā\
rain	\ˈrān\
raise	\ˈrāz\
range	\ˈrānj\
rank	\ˈraŋk\
rapid	 \ˈra-pəd\
rapidly	 \ˈra-pəd\
rare	\ˈrer\
rarely	 \ˈrer-lē\
rate	\ˈrāt\
rather	 \ˈra-t͟hər , ˈrä-, ˈrə- also ˈre-; interjectionally ˈra-ˈt͟hər, ˈrä-, ˈrə-\
ratio	 \ˈrā-(ˌ)shō , -shē-ˌō\
raw	\ˈrȯ\
reach	\ˈrēch\
react	 \rē-ˈakt\
reaction	 \rē-ˈak-shən\
read	\ˈrēd\
reader	 \ˈrē-dər\
readily	 \ˈre-də-lē\
reading	 \ˈrē-diŋ\
ready	\ˈre-dē\
real	 \ˈrē(-ə)l\
realistic	 \ˌrē-ə-ˈli-stik\
reality	 \rē-ˈa-lə-tē\
realize	 \ˈrē-ə-ˌlīz\
really	 \ˈrē-(ə-)lē\
reason	 \ˈrē-zᵊn\
reasonable	 \ˈrēz-nə-bəl , ˈrē-zᵊn-ə-bəl\
reasonably	 \ˈrēz-nə-bəl , ˈrē-zᵊn-ə-bəl\
recall	 \ri-ˈkȯl\
receipt	 \ri-ˈsēt\
receive	 \ri-ˈsēv\
recent	 \ˈrē-sᵊnt\
recently	 \ˈrē-sᵊnt-lē\
reception	 \ri-ˈsep-shən\
recipe	 \ˈre-sə-(ˌ)pē\
reckon	 \ˈre-kən\
recognition	 \ˌre-kig-ˈni-shən , -kəg-\
recognize	 \ˈre-kig-ˌnīz , -kəg-\
recommend	 \ˌre-kə-ˈmend\
recommendation	 \ˌre-kə-mən-ˈdā-shən , -ˌmen-\
record	 \ri-ˈkȯrd\
recording	 \ri-ˈkȯr-diŋ\
recover	 \ri-ˈkə-vər\
recovery	 \ri-ˈkə-və-rē , -ˈkəv-rē\
red	\ˈred\
reduce	 \ri-ˈdüs , -ˈdyüs\
reduction	 \ri-ˈdək-shən\
refer	 \ri-ˈfər\
reference	 \ˈre-fərn(t)s , ˈre-f(ə-)rən(t)s\
reflect	 \ri-ˈflekt\
reflection	 \ri-ˈflek-shən\
reform	 \ri-ˈfȯrm\
refrigerator	 \ri-ˈfri-jə-ˌrā-tər\
refuse	 \ri-ˈfyüz\
regard	 \ri-ˈgärd\
regime	 \rā-ˈzhēm , ri- also ri-ˈjēm\
region	 \ˈrē-jən\
regional	 \ˈrēj-nəl , ˈrē-jə-nᵊl\
register	 \ˈre-jə-stər\
registration	 \ˌre-jə-ˈstrā-shən\
regret	 \ri-ˈgret\
regular	 \ˈre-gyə-lər , ˈre-g(ə-)lər also ˈrā-\
regularly	 \ˈre-gyə-lər-lē , ˈre-gyər-lē, ˈre-gyə-lē also ˈrā-\
regulation	 \ˌre-gyə-ˈlā-shən , ˌre-gə- also ˌrā-\
reinforce	 \ˌrē-ən-ˈfȯrs\
reject	 \ri-ˈjekt\
relate	 \ri-ˈlāt\
related	 \ri-ˈlā-təd\
relation	 \ri-ˈlā-shən\
relationship	 \ri-ˈlā-shən-ˌship\
relative	 \ˈre-lə-tiv\
relatively	 \ˈre-lə-tiv-lē\
relax	 \ri-ˈlaks\
release	 \ri-ˈlēs\
relevant	 \ˈre-lə-vənt\
relief	 \ri-ˈlēf\
relieve	 \ri-ˈlēv\
religion	 \ri-ˈli-jən\
religious	 \ri-ˈli-jəs\
rely	 \ri-ˈlī\
remain	 \ri-ˈmān\
remaining	 \ri-ˈmā-niŋ\
remains	 \ri-ˈmān\
remark	 \ri-ˈmärk\
remarkable	 \ri-ˈmär-kə-bəl\
remember	 \ri-ˈmem-bər\
remind	 \ri-ˈmīnd\
remote	 \ri-ˈmōt\
remove	 \ri-ˈmüv\
rent	\ˈrent\
repair	 \ri-ˈper\
repeat	 \ri-ˈpēt\
replace	 \ri-ˈplās\
replacement	 \ri-ˈplās-mənt\
reply	 \ri-ˈplī\
report	 \ri-ˈpȯrt\
reporter	 \ri-ˈpȯr-tər\
represent	 \ˌre-pri-ˈzent\
representation	 \ˌre-pri-ˌzen-ˈtā-shən , -zən-\
representative	 \ˌre-pri-ˈzen-tə-tiv\
republic	 \ri-ˈpə-blik\
reputation	 \ˌre-pyə-ˈtā-shən\
request	 \ri-ˈkwest\
require	 \ri-ˈkwī(-ə)r\
requirement	 \ri-ˈkwī(-ə)r-mənt\
rescue	 \ˈre-(ˌ)skyü\
research	 \ri-ˈsərch , ˈrē-ˌsərch\
reserve	 \ri-ˈzərv\
resident	 \ˈre-zə-dənt , ˈrez-dənt, ˈre-zə-ˌdent\
residential	 \ˌre-zə-ˈden(t)-shəl , ˌrez-ˈden(t)-\
resign	 \ri-ˈzīn\
resignation	 \ˌre-zig-ˈnā-shən\
resist	 \ri-ˈzist\
resistance	 \ri-ˈzi-stən(t)s\
resolution	 \ˌre-zə-ˈlü-shən\
resolve	 \ri-ˈzälv , -ˈzȯlv also -ˈzäv or -ˈzȯv\
resort	 \ri-ˈzȯrt\
resource	 \ˈrē-ˌsȯrs , -ˌzȯrs, ri-ˈsȯrs, -ˈzȯrs\
respect	 \ri-ˈspekt\
respectively	 \ri-ˈspek-tiv-lē\
respond	 \ri-ˈspänd\
response	 \ri-ˈspän(t)s\
responsibility	 \ri-ˌspän(t)-sə-ˈbi-lə-tē\
responsible	 \ri-ˈspän(t)-sə-bəl\
rest	\ˈrest\
restaurant	 \ˈre-stə-ˌränt , -stränt also -st(ə-)rənt, -stərnt\
restore	 \ri-ˈstȯr\
restrict	 \ri-ˈstrikt\
restriction	 \ri-ˈstrik-shən\
result	 \ri-ˈzəlt\
retain	 \ri-ˈtān\
retire	 \ri-ˈtī(-ə)r\
retirement	 \ri-ˈtī(-ə)r-mənt\
return	 \ri-ˈtərn\
reveal	 \ri-ˈvēl\
revenue	 \ˈre-və-ˌnü , -ˌnyü\
reverse	 \ri-ˈvərs\
review	 \ri-ˈvyü\
revolution	 \ˌre-və-ˈlü-shən\
reward	 \ri-ˈwȯrd\
rhythm	\ˈri-t͟həm\
rice	\ˈrīs\
rich	\ˈrich\
rid	\ˈrid\
ride	\ˈrīd\
ridiculous	 \rə-ˈdi-kyə-ləs\
right	\ˈrīt\
ring	\ˈriŋ\
rip	\ˈrip\
rise	\ˈrīz\
risk	\ˈrisk\
rival	 \ˈrī-vəl\
river	 \ˈri-vər\
road	\ˈrōd\
rob	\ˈräb\
rock	\ˈräk\
role	\ˈrōl\
roll	\ˈrōl\
roof	\ˈrüf , ˈru̇f\
room	\ˈrüm , ˈru̇m\
root	\ˈrüt , ˈru̇t\
rope	\ˈrōp\
rough	\ˈrəf\
roughly	 \ˈrə-flē\
round	\ˈrau̇nd\
route	\ˈrüt , ˈrau̇t\
routine	 \rü-ˈtēn\
row	\ˈrō\
royal	 \ˈrȯi(-ə)l\
rub	\ˈrəb\
rubber	 \ˈrə-bər\
rubbish	 \ˈrə-bish , dialectal -bij\
rude	\ˈrüd\
ruin	 \ˈrü-ən , -ˌin; ˈrün\
rule	\ˈrül\
run	\ˈrən\
rural	 \ˈru̇r(-ə)l , ˈrər(-ə)l\
rush	\ˈrəsh\
sack	\ˈsak\
sad	\ˈsad\
safe	\ˈsāf\
safety	 \ˈsāf-tē\
sail	\ˈsāl , as last element in compounds often səl\
sake	\ˈsāk\
salad	 \ˈsa-ləd\
salary	 \ˈsal-rē , ˈsa-lə-\
sale	\ˈsāl\
salt	\ˈsȯlt\
same	\ˈsām\
sample	 \ˈsam-pəl\
sand	\ˈsand\
sandwich	 \ˈsan(d)-ˌwich , ˈsam-; dialectal ˈsaŋ-\
satellite	 \ˈsa-tə-ˌlīt\
satisfaction	 \ˌsa-təs-ˈfak-shən\
satisfied	 \ˈsa-təs-ˌfīd\
satisfy	 \ˈsa-təs-ˌfī\
sauce	\ˈsȯs , usually ˈsas for sense 4\
sausage	 \ˈsȯ-sij\
save	\ˈsāv\
saving	 \ˈsā-viŋ\
say	\ˈsā , Southern also ˈse\
scale	\ˈskāl\
scared	\ˈskerd\
scene	\ˈsēn\
schedule	 \ˈske-(ˌ)jül , -jəl, Canadian also ˈshe-, British usually ˈshe-(ˌ)dyül\
scheme	\ˈskēm\
school	\ˈskül\
science	 \ˈsī-ən(t)s\
scientific	 \ˌsī-ən-ˈti-fik\
scientist	 \ˈsī-ən-tist\
scope	\ˈskōp\
score	\ˈskȯr\
scratch	\ˈskrach\
scream	\ˈskrēm\
screen	\ˈskrēn\
screw	\ˈskrü\
script	\ˈskript\
sea	\ˈsē\
seal	\ˈsēl\
search	\ˈsərch\
season	 \ˈsē-zᵊn\
seat	\ˈsēt\
second	 \ˈse-kənd  also -kənt, especially before a consonant -kən, -kᵊŋ\
secondary	 \ˈse-kən-ˌder-ē\
secondly	 \ˈse-kən(d)-lē\
secret	 \ˈsē-krət\
secretary	 \ˈse-krə-ˌter-ē , ˈse-kə-ˌter-, in rapid speech also ˈsek-ˌter-, especially British ˈse-k(r)ə-trē\
section	 \ˈsek-shən\
sector	 \ˈsek-tər , -ˌtȯr\
secure	 \si-ˈkyu̇r , -ˈkyər\
security	 \si-ˈkyu̇r-ə-tē , -ˈkyər-\
see	\ˈsē\
seed	\ˈsēd\
seek	\ˈsēk\
seem	\ˈsēm\
seize	\ˈsēz\
select	 \sə-ˈlekt\
selection	 \sə-ˈlek-shən\
self	\ˈself , Southern also ˈsef\
sell	\ˈsel\
send	\ˈsend\
senior	 \ˈsē-nyər\
sense	\ˈsen(t)s\
sensible	 \ˈsen(t)-sə-bəl\
sensitive	 \ˈsen(t)-sə-tiv , ˈsen(t)s-təv\
sentence	 \ˈsen-tᵊn(t)s , -tᵊnz\
separate	 \ˈse-pə-ˌrāt , ˈse-ˌprāt\
sequence	 \ˈsē-kwən(t)s , -ˌkwen(t)s\
series	 \ˈsir-(ˌ)ēz\
serious	 \ˈsir-ē-əs\
seriously	 \ˈsir-ē-əs-lē\
servant	 \ˈsər-vənt\
serve	\ˈsərv\
service	 \ˈsər-vəs\
session	 \ˈse-shən\
set	\ˈset\
setting	 \ˈse-tiŋ\
settle	 \ˈse-tᵊl\
settlement	 \ˈse-tᵊl-mənt\
several	 \ˈsev-rəl , ˈse-və-\
severe	 \sə-ˈvir\
sew	\ˈsō\
sex	\ˈseks\
sexual	 \ˈsek-sh(ə-)wəl , ˈsek-shəl\
shadow	 \ˈsha-(ˌ)dō\
shake	\ˈshāk\
shall	\shəl, ˈshal\
shame	\ˈshām\
shape	\ˈshāp\
share	\ˈsher\
sharp	\ˈshärp\
sharply	\ˈshärp\
shave	\ˈshāv\
she	\ˈshē\
shed	\ˈshed\
sheep	\ˈshēp\
sheet	\ˈshēt\
shelf	\ˈshelf\
shell	\ˈshel\
shelter	 \ˈshel-tər\
shift	\ˈshift\
shine	\ˈshīn\
ship	\ˈship\
shirt	\ˈshərt\
shock	\ˈshäk\
shocked	\ˈshäkt\
shocking	 \ˈshä-kiŋ\
shoe	\ˈshü\
shoot	\ˈshüt\
shop	\ˈshäp\
shopping	\ˈshäp\
short	\ˈshȯrt\
shortly	 \ˈshȯrt-lē\
shot	\ˈshät\
should	\shəd, ˈshu̇d\
shoulder	 \ˈshōl-dər\
shout	\ˈshau̇t\
shove	\ˈshəv\
show	\ˈshō\
shower	 \ˈshau̇(-ə)r\
shrug	\ˈshrəg , especially Southern ˈsrəg\
shut	\ˈshət\
sick	\ˈsik\
side	\ˈsīd\
sight	\ˈsīt\
sign	\ˈsīn\
signal	 \ˈsig-nᵊl\
signature	 \ˈsig-nə-ˌchu̇r , -chər, -ˌtyu̇r, -ˌtu̇r\
significance	 \sig-ˈni-fi-kən(t)s\
significant	 \sig-ˈni-fi-kənt\
significantly	 \sig-ˈni-fi-kənt-lē\
silence	 \ˈsī-lən(t)s\
silent	 \ˈsī-lənt\
silly	 \ˈsi-lē\
silver	 \ˈsil-vər\
similar	 \ˈsi-mə-lər , ˈsim-lər\
similarly	 \ˈsi-mə-lər , ˈsim-lər\
simple	 \ˈsim-pəl\
simply	 \ˈsim-plē , for sense 1 also -pə-lē\
sin	\ˈsin\
since	\ˈsin(t)s\
sing	\ˈsiŋ\
singer	 \ˈsiŋ-ər\
single	 \ˈsiŋ-gəl\
sink	\ˈsiŋk\
sir	\ˈsər\
sister	 \ˈsi-stər\
sit	\ˈsit\
site	\ˈsīt\
situation	 \ˌsi-chə-ˈwā-shən\
size	\ˈsīz\
skill	\ˈskil\
skin	\ˈskin\
skirt	\ˈskərt\
sky	\ˈskī\
sleep	\ˈslēp\
slice	\ˈslīs\
slide	\ˈslīd\
slight	\ˈslīt\
slightly	\ˈslīt\
slim	\ˈslim\
slip	\ˈslip\
slope	\ˈslōp\
slow	\ˈslō\
slowly	 \ˈslō-lē\
small	\ˈsmȯl\
smart	\ˈsmärt\
smell	\ˈsmel\
smile	\ˈsmī(-ə)l\
smoke	\ˈsmōk\
smoking	\ˈsmōk\
smooth	\ˈsmüt͟h\
snap	\ˈsnap\
snow	\ˈsnō\
so	\ˈsō , especially before an adjective or adverb followed by "that" sə\
so-called	\ˈsō-ˈkȯld\
soap	\ˈsōp\
social	 \ˈsō-shəl\
society	 \sə-ˈsī-ə-tē\
sock	\ˈsäk\
soft	\ˈsȯft\
software	 \ˈsȯft-ˌwer\
soil	\ˈsȯi(-ə)l\
soldier	 \ˈsōl-jər\
sole	\ˈsōl\
solicitor	 \sə-ˈli-sə-tər , -ˈli-stər\
solid	 \ˈsä-ləd\
solution	 \sə-ˈlü-shən\
solve	\ˈsälv , ˈsȯlv\
some	\ˈsəm , for sense 2 without stress \
somebody	 \ˈsəm-(ˌ)bə-dē , -ˌbä-\
somehow	 \ˈsəm-ˌhau̇\
someone	 \ˈsəm-(ˌ)wən\
something	 \ˈsəm(p)-thiŋ , especially in rapid speech or for sense 2 ˈsəm-pᵊm\
sometimes	 \ˈsəm-ˌtīmz also (ˌ)səm-ˈtīmz\
somewhat	 \ˈsəm-ˌ ; (ˌ)səm-ˈ(h)wät, -ˈ(h)wət\
somewhere	 \ˈsəm-ˌ(h)wer , -(ˌ)(h)wər\
son	\ˈsən\
song	\ˈsȯŋ\
soon	\ˈsün , especially New England ˈsu̇n\
sore	\ˈsȯr\
sorry	 \ˈsär-ē , ˈsȯr-\
sort	\ˈsȯrt\
soul	\ˈsōl\
sound	\ˈsau̇nd\
soup	\ˈsüp\
source	\ˈsȯrs\
south	\ˈsau̇th\
southern	 \ˈsə-t͟hərn\
space	\ˈspās\
spare	\ˈsper\
speak	\ˈspēk\
speaker	 \ˈspē-kər\
special	 \ˈspe-shəl\
specialist	 \ˈspe-sh(ə-)list\
species	 \ˈspē-(ˌ)shēz , -(ˌ)sēz\
specific	 \spi-ˈsi-fik\
specifically	 \spi-ˈsi-fi-k(ə-)lē\
specify	 \ˈspe-sə-ˌfī\
speech	\ˈspēch\
speed	\ˈspēd\
spell	\ˈspel\
spelling	 \ˈspe-liŋ\
spend	\ˈspend\
spill	\ˈspil\
spin	\ˈspin\
spirit	 \ˈspir-ət\
spiritual	 \ˈspir-i-chə-wəl , -i-chəl, -ich-wəl\
spite	\ˈspīt\
split	\ˈsplit\
spoil	\ˈspȯi(-ə)l\
spokesman	 \ˈspōks-mən\
spoon	\ˈspün\
sport	\ˈspȯrt\
spot	\ˈspät\
spray	\ˈsprā\
spread	\ˈspred\
spring	\ˈspriŋ\
squad	\ˈskwäd\
square	\ˈskwer\
squeeze	\ˈskwēz\
stable	 \ˈstā-bəl\
staff	\ˈstaf\
stage	\ˈstāj\
stair	\ˈster\
stake	\ˈstāk\
stall	\ˈstȯl\
stamp	\ˈstamp ; transitive sense 2a & intransitive sense 2 are also ˈstämp or ˈstȯmp\
stand	\ˈstand\
standard	 \ˈstan-dərd\
star	\ˈstär\
stare	\ˈster\
start	\ˈstärt\
starve	\ˈstärv\
state	\ˈstāt\
statement	 \ˈstāt-mənt\
station	 \ˈstā-shən\
statistic	 \stə-ˈti-stik\
status	 \ˈstā-təs , ˈsta-\
stay	\ˈstā\
steady	\ˈste-dē\
steak	\ˈstāk\
steal	\ˈstēl\
steam	\ˈstēm\
steel	\ˈstēl\
steep	\ˈstēp\
step	\ˈstep\
stick	\ˈstik\
stiff	\ˈstif\
still	\ˈstil\
stir	\ˈstər\
stock	\ˈstäk\
stomach	 \ˈstə-mək , -mik\
stone	\ˈstōn\
stop	\ˈstäp\
storage	 \ˈstȯr-ij\
store	\ˈstȯr\
storm	\ˈstȯrm\
story	 \ˈstȯr-ē\
straight	\ˈstrāt\
straightforward	 \ˌstrāt-ˈfȯr-wərd , ˈstrāt-ˌfȯr-\
strain	\ˈstrān\
strange	\ˈstrānj\
stranger	 \ˈstrān-jər\
strategic	 \strə-ˈtē-jik\
strategy	 \ˈstra-tə-jē\
straw	\ˈstrȯ\
strawberry	 \ˈstrȯ-ˌber-ē , -b(ə-)rē\
stream	\ˈstrēm\
street	\ˈstrēt\
strength	\ˈstreŋ(k)th , ˈstren(t)th\
strengthen	 \ˈstreŋ(k)-thən , ˈstren(t)-\
stress	\ˈstres\
stretch	\ˈstrech\
strict	\ˈstrikt\
strike	\ˈstrīk\
string	\ˈstriŋ\
strip	\ˈstrip\
stroke	\ˈstrōk\
strong	\ˈstrȯŋ\
strongly	 \ˈstrȯŋ-lē\
structure	 \ˈstrək-chər\
struggle	 \ˈstrə-gəl\
student	 \ˈstü-dᵊnt , ˈstyü-, chiefly Southern -dənt\
studio	 \ˈstü-dē-(ˌ)ō , ˈstyü-\
study	\ˈstə-dē\
stuff	\ˈstəf\
stupid	 \ˈstü-pəd , ˈstyü-\
style	\ˈstī(-ə)l\
subject	 \ˈsəb-jikt , -(ˌ)jekt\
submit	 \səb-ˈmit\
subsequent	 \ˈsəb-si-kwənt , -sə-ˌkwent\
subsequently	 \ˈsəb-si-ˌkwent-lē , -kwənt-\
substance	 \ˈsəb-stən(t)s\
substantial	 \səb-ˈstan(t)-shəl\
succeed	 \sək-ˈsēd\
success	 \sək-ˈses\
successful	 \sək-ˈses-fəl\
successfully	 \sək-ˈses-fəl\
such	\ˈsəch , ˈsich\
suck	\ˈsək\
sudden	 \ˈsə-dᵊn\
suddenly	 \ˈsə-dᵊn\
suffer	 \ˈsə-fər\
sufficient	 \sə-ˈfi-shənt\
sugar	 \ˈshu̇-gər\
suggest	 \səg-ˈjest , sə-ˈjest\
suggestion	 \səg-ˈjes-chən , sə-ˈjes-, -ˈjesh-\
suit	\ˈsüt\
suitable	 \ˈsü-tə-bəl\
sum	\ˈsəm\
summer	 \ˈsə-mər\
sun	\ˈsən\
super	 \ˈsü-pər\
supermarket	 \ˈsü-pər-ˌmär-kət\
supper	 \ˈsə-pər\
supply	 \sə-ˈplī\
support	 \sə-ˈpȯrt\
supporter	 \sə-ˈpȯr-tər\
suppose	 \sə-ˈpōz , usually after "I" ˈspōz\
sure	\ˈshu̇r , ˈshər, especially Southern ˈshȯr\
surely	 \ˈshu̇r-lē , ˈshər-, especially Southern ˈshȯr-\
surface	 \ˈsər-fəs\
surgery	 \ˈsərj-rē , ˈsər-jə-\
surprise	 \sər-ˈprīz , sə-\
surprised	 \sər-ˈprīzd , sə-\
surprising	 \sər-ˈprī-ziŋ , sə-\
surprisingly	 \sər-ˈprī-ziŋ-lē , sə-\
surround	 \sə-ˈrau̇nd\
survey	 \sər-ˈvā , ˈsər-ˌvā\
survival	 \sər-ˈvī-vəl\
survive	 \sər-ˈvīv\
suspect	 \ˈsə-ˌspekt , sə-ˈspekt\
suspicion	 \sə-ˈspi-shən\
suspicious	 \sə-ˈspi-shəs\
sustain	 \sə-ˈstān\
swap	\ˈswäp\
swear	\ˈswer\
sweep	\ˈswēp\
sweet	\ˈswēt\
swim	\ˈswim\
swimming	 \ˈswi-miŋ\
swing	\ˈswiŋ\
switch	\ˈswich\
symbol	 \ˈsim-bəl\
sympathy	 \ˈsim-pə-thē\
system	 \ˈsi-stəm\
table	 \ˈtā-bəl\
tablet	 \ˈta-blət\
tackle	 \ˈta-kəl , nautical often ˈtā-\
tail	\ˈtāl\
take	\ˈtāk\
tale	\ˈtāl\
talent	 \ˈta-lənt\
talk	\ˈtȯk\
tall	\ˈtȯl\
tank	\ˈtaŋk\
tap	\ˈtap\
tape	\ˈtāp\
target	 \ˈtär-gət\
task	\ˈtask\
taste	\ˈtāst\
tax	\ˈtaks\
taxi	\ˈtak-sē\
tea	\ˈtē\
teach	\ˈtēch\
teacher	 \ˈtē-chər\
teaching	 \ˈtē-chiŋ\
team	\ˈtēm\
tear	\ˈter\
technical	 \ˈtek-ni-kəl\
technique	 \tek-ˈnēk\
technology	 \tek-ˈnä-lə-jē\
telephone	 \ˈte-lə-ˌfōn\
television	 \ˈte-lə-ˌvi-zhən , especially British ˌte-lə-ˈvi-\
tell	\ˈtel\
telly	 \ˈte-lē\
temperature	 \ˈtem-pər-ˌchu̇r , ˈtem-pə-, -p(ə-)rə-, -chər, -ˌtyu̇r, -ˌtu̇r\
temporary	 \ˈtem-pə-ˌrer-ē\
tend	\ˈtend\
tendency	 \ˈten-dən(t)-sē\
tennis	 \ˈte-nəs\
tension	 \ˈten(t)-shən\
tent	\ˈtent\
term	\ˈtərm\
terrible	 \ˈter-ə-bəl , ˈte-rə-\
terribly	 \ˈter-ə-bəl , ˈte-rə-\
territory	 \ˈter-ə-ˌtȯr-ē\
terror	 \ˈter-ər , ˈte-rər\
terrorist	 \ˈter-ər-ist\
test	\ˈtest\
text	\ˈtekst\
than	\t͟hən, ˈt͟han\
thank	\ˈthaŋk\
thanks	\ˈthaŋ(k)s\
that	\ˈt͟hat , t͟hət\
the	\before consonants usually t͟hə , before vowels usually t͟hē, sometimes before vowels also t͟hə; for emphasis before titles and names or to suggest uniqueness often ˈt͟hē\
theatre	 \ˈthē-ə-tər , ˈthēə-, usually in Southern ˈthē-ˌā- also thē-ˈā-\
their	\t͟hər, ˈt͟her\
theirs	\ˈt͟herz\
them	\(t͟h)əm, ˈt͟hem , after p, b, v, f also ᵊm\
theme	\ˈthēm\
themselves	 \t͟həm-ˈselvz, t͟hem-\
then	\ˈt͟hen\
theoretical	 \ˌthē-ə-ˈre-ti-kəl , ˌthir-ˈe-ti-kəl\
theory	 \ˈthē-ə-rē , ˈthir-ē\
there	\ˈt͟her\
therefore	 \ˈt͟her-ˌfȯr\
they	\ˈt͟hā\
thick	\ˈthik\
thin	\ˈthin\
thing	\ˈthiŋ\
think	\ˈthiŋk\
this	\ˈt͟his , t͟həs\
though	\ˈt͟hō\
thought	\ˈthȯt\
threat	\ˈthret\
threaten	 \ˈthre-tᵊn\
three	\ˈthrē\
throat	\ˈthrōt\
through	\ˈthrü\
throughout	 \thrü-ˈau̇t\
throw	\ˈthrō\
thus	\ˈt͟həs\
ticket	 \ˈti-kət\
tidy	 \ˈtī-dē\
tie	\ˈtī\
tight	\ˈtīt\
tile	\ˈtī(-ə)l\
till	\tᵊl, təl, ˈtil\
time	\ˈtīm\
tin	\ˈtin\
tiny	 \ˈtī-nē\
tip	\ˈtip\
tired	\ˈtī(-ə)rd\
title	 \ˈtī-tᵊl\
to	\tə, tu̇, ˈtü\
toast	\ˈtōst\
today	 \tə-ˈdā\
toe	\ˈtō\
together	 \tə-ˈge-t͟hər\
toilet	 \ˈtȯi-lət\
tomato	 \tə-ˈmā-(ˌ)tō ; chiefly in Britain, eastern New England, northeastern Virginia, and sometimes elsewhere in cultivated speech -ˈmä-; chiefly in Northern US -ˈma-\
tomorrow	 \tə-ˈmär-(ˌ)ō , -ˈmȯr-\
ton	\ˈtən\
tone	\ˈtōn\
tongue	\ˈtəŋ\
tonight	 \tə-ˈnīt\
too	\ˈtü\
tool	\ˈtül\
tooth	\ˈtüth\
top	\ˈtäp\
topic	 \ˈtä-pik\
total	 \ˈtō-tᵊl\
totally	 \ˈtō-tᵊl-ē\
touch	\ˈtəch\
tough	\ˈtəf\
tour	\ˈtu̇r , sense 2 is also ˈtau̇(-ə)r\
tourist	 \ˈtu̇r-ist\
towards	 \ˈtō-ərd , ˈtȯ(-ə)rd\
towel	 \ˈtau̇(-ə)l\
tower	 \ˈtau̇(-ə)r\
town	\ˈtau̇n\
toy	\ˈtȯi\
track	\ˈtrak\
trade	\ˈtrād\
tradition	 \trə-ˈdi-shən\
traditional	 \trə-ˈdish-nəl , -ˈdi-shə-nᵊl\
traffic	 \ˈtra-fik\
trailer	 \ˈtrā-lər\
train	\ˈtrān\
trainer	 \ˈtrā-nər\
training	 \ˈtrā-niŋ\
transaction	 \tran-ˈzak-shən , tran(t)-ˈsak-\
transfer	 \tran(t)s-ˈfər , ˈtran(t)s-ˌfər\
transform	 \tran(t)s-ˈfȯrm\
transition	 \tran(t)-ˈsi-shən , tran-ˈzi-, chiefly British tran(t)-ˈsi-zhən\
translate	 \tran(t)s-ˈlāt , tranz-; ˈtran(t)s-ˌlāt, ˈtranz-\
transport	 \tran(t)s-ˈpȯrt , ˈtran(t)s-ˌpȯrt\
transportation	 \ˌtran(t)s-pər-ˈtā-shən\
trash	\ˈtrash\
travel	 \ˈtra-vəl\
tray	\ˈtrā\
treat	\ˈtrēt\
treatment	 \ˈtrēt-mənt\
treaty	 \ˈtrē-tē\
tree	\ˈtrē\
tremendous	 \tri-ˈmen-dəs\
trend	\ˈtrend\
trial	 \ˈtrī(-ə)l\
trick	\ˈtrik\
tricky	\ˈtri-kē\
trip	\ˈtrip\
troop	\ˈtrüp\
trouble	 \ˈtrə-bəl\
trousers	 \ˈtrau̇-zər\
truck	\ˈtrək\
true	\ˈtrü\
truly	 \ˈtrü-lē\
trust	\ˈtrəst\
truth	\ˈtrüth\
try	\ˈtrī\
tube	\ˈtüb , ˈtyüb\
tune	\ˈtün , ˈtyün\
tunnel	 \ˈtə-nᵊl\
turn	\ˈtərn\
twice	\ˈtwīs\
twist	\ˈtwist\
type	\ˈtīp\
typical	 \ˈti-pi-kəl\
tyre	\ˈtī(-ə)r\
ugly	 \ˈə-glē\
ultimate	 \ˈəl-tə-mət\
ultimately	 \ˈəl-tə-mət-lē\
unable	 \ˌən-ˈā-bəl\
unbelievable	 \ˌən-bə-ˈlē-və-bəl\
uncle	 \ˈəŋ-kəl\
under	 \ˈən-dər\
underneath	 \ˌən-dər-ˈnēth\
understand	 \ˌən-dər-ˈstand\
understanding	 \ˌən-dər-ˈstan-diŋ\
undertake	 \ˌən-dər-ˈtāk\
unemployed	 \ˌən-im-ˈplȯid\
unemployment	 \ˌən-im-ˈplȯi-mənt\
unfair	 \ˌən-ˈfer\
unfortunate	 \ˌən-ˈfȯrch-nət , -ˈfȯr-chə-\
unfortunately	 \ˌən-ˈfȯrch-nət-lē , -ˈfȯr-chə-\
unhappy	 \ˌən-ˈha-pē\
uniform	 \ˈyü-nə-ˌfȯrm\
union	\ˈyün-yən\
unique	\yu̇-ˈnēk\
unit	\ˈyü-nət\
united	 \yu̇-ˈnī-təd\
unity	 \ˈyü-nə-tē\
universal	 \ˌyü-nə-ˈvər-səl\
universe	 \ˈyü-nə-ˌvərs\
university	 \ˌyü-nə-ˈvər-sə-tē , -ˈvər-stē\
unknown	 \ˌən-ˈnōn\
unless	 \ən-ˈles , ˈən-ˌles\
unlike	 \ˌən-ˈlīk\
unlikely	 \ˌən-ˈlī-klē\
until	 \ən-ˈtil , -ˈtel; ˈən-ˌtil, -ˌtel, -tᵊl\
unusual	 \ˌən-ˈyü-zhə-wəl , -zhəl; -ˈyüzh-wəl\
up	\ˈəp\
upon	 \ə-ˈpȯn , -ˈpän\
upper	 \ˈə-pər\
upset	 \(ˌ)əp-ˈset\
upstairs	 \ˌəp-ˈsterz\
urban	 \ˈər-bən\
urge	\ˈərj\
urgent	 \ˈər-jənt\
us	\ˈəs\
use	\ˈyüz\
used	\ˈyüzd , in the phrase "used to" usually ˈyüs(t)\
useful	 \ˈyüs-fəl\
user	 \ˈyü-zər\
usual	 \ˈyü-zhə-wəl , -zhəl; ˈyüzh-wəl\
usually	 \ˈyü-zhə-wə-lē , -zhə-lē; ˈyüzh-wə-lē, ˈyüzh-lē\
vacation	 \vā-ˈkā-shən , və-\
vague	\ˈvāg\
valley	 \ˈva-lē\
valuable	 \ˈval-yə-bəl , -yə-wə-bəl, -yü-ə-\
value	 \ˈval-(ˌ)yü\
van	\ˈvan\
variation	 \ˌver-ē-ˈā-shən\
variety	 \və-ˈrī-ə-tē\
various	 \ˈver-ē-əs\
vary	\ˈver-ē\
vast	\ˈvast\
vegetable	 \ˈvej-tə-bəl , ˈve-jə-\
vehicle	 \ˈvē-ə-kəl  also ˈvē-ˌhi-kəl\
version	 \ˈvər-zhən , -shən\
very	\ˈver-ē , ˈve-rē\
vet	\ˈvet\
via	\ˈvī-ə , ˈvē-ə\
victim	 \ˈvik-təm\
victory	 \ˈvik-t(ə-)rē\
video	 \ˈvi-dē-ˌō\
view	\ˈvyü\
village	 \ˈvi-lij\
violence	 \ˈvī-lən(t)s , ˈvī-ə-\
violent	 \ˈvī-ə-lənt\
virtually	 \ˈvər-chə-wə-lē , -chə-lē; ˈvərch-wə-lē\
virtue	 \ˈvər-(ˌ)chü\
virus	 \ˈvī-rəs\
visible	 \ˈvi-zə-bəl\
vision	 \ˈvi-zhən\
visit	 \ˈvi-zət\
visitor	 \ˈvi-zə-tər , ˈviz-tər\
visual	 \ˈvi-zhə-wəl , -zhəl; ˈvizh-wəl\
vital	 \ˈvī-tᵊl\
voice	\ˈvȯis\
volume	 \ˈväl-(ˌ)yüm , -yəm\
voluntary	 \ˈvä-lən-ˌter-ē\
vote	\ˈvōt\
vulnerable	 \ˈvəl-n(ə-)rə-bəl , ˈvəl-nər-bəl\
wage	\ˈwāj\
wait	\ˈwāt\
wake	\ˈwāk\
walk	\ˈwȯk\
wall	\ˈwȯl\
wander	 \ˈwän-dər\
want	\ˈwȯnt also ˈwänt and ˈwənt\
war	\ˈwȯr\
ward	\ˈwȯrd\
wardrobe	 \ˈwȯr-ˌdrōb\
warm	\ˈwȯrm\
warn	\ˈwȯrn\
warning	 \ˈwȯr-niŋ\
wash	\ˈwȯsh , ˈwäsh, chiefly Midland also ˈwȯrsh  or ˈwärsh\
washing	 \ˈwȯ-shiŋ , ˈwä-\
waste	\ˈwāst\
watch	\ˈwäch , ˈwȯch\
water	 \ˈwȯ-tər , ˈwä-\
wave	\ˈwāv\
way	\ˈwā\
we	\ˈwē\
weak	\ˈwēk\
weakness	 \ˈwēk-nəs\
wealth	\ˈwelth also ˈweltth\
weapon	 \ˈwe-pən\
wear	\ˈwer\
weather	 \ˈwe-t͟hər\
web	\ˈweb\
website	 \ˈweb-ˌsīt\
wedding	 \ˈwe-diŋ\
week	\ˈwēk\
weekend	 \ˈwēk-ˌend\
weekly	 \ˈwē-klē\
weigh	\ˈwā\
weight	\ˈwāt\
weird	\ˈwird\
welcome	 \ˈwel-kəm\
welfare	 \ˈwel-ˌfer\
well	\ˈwel\
west	\ˈwest\
western	 \ˈwe-stərn\
wet	\ˈwet\
what	\ˈhwät , ˈhwət, ˈwät, ˈwət\
whatever	 \hwät-ˈe-vər , wät-, (h)wət-\
whatsoever	 \ˌhwät-sə-ˈwe-vər , ˌwät-, ˌ(h)wət-\
wheel	\ˈhwēl , ˈwēl\
when	\ˈhwen , ˈwen, (h)wən\
whenever	 \hwe-ˈne-vər , we-, (h)wə-\
where	\ˈhwer , ˈwer, (ˌ)(h)wər\
whereas	 \hwer-ˈaz , wer-, (ˌ)(h)wər-\
wherever	 \hwer-ˈe-vər , wer-, (ˌ)(h)wər-\
whether	 \ˈhwe-t͟hər , ˈwe-, (ˌ)(h)wə-\
which	\ˈhwich , ˈwich\
while	\ˈhwī(-ə)l , ˈwī(-ə)l\
whisky	 \ˈhwi-skē , ˈwi-\
whisper	 \ˈhwi-spər , ˈwi-\
white	\ˈhwīt , ˈwīt\
who	\ˈhü , ü\
whoever	 \hü-ˈe-vər\
whole	\ˈhōl\
whom	\ˈhüm , üm\
whose	\ˈhüz , üz\
why	\ˈhwī , ˈwī\
wicked	 \ˈwi-kəd\
wide	\ˈwīd\
widely	 \ˈwīd-lē\
widespread	 \ˈwīd-ˈspred\
wife	\ˈwīf\
wild	\ˈwī(-ə)ld\
will	\wəl, (ə)l, ᵊl, ˈwil\
willing	 \ˈwi-liŋ\
win	\ˈwin\
wind	\ˈwind , archaic or poetic ˈwīnd\
window	 \ˈwin-(ˌ)dō\
windy	\ˈwin-dē\
wine	\ˈwīn\
wing	\ˈwiŋ\
winner	 \ˈwi-nər\
winter	 \ˈwin-tər\
wipe	\ˈwīp\
wire	\ˈwī(-ə)r\
wise	\ˈwīz\
wish	\ˈwish\
with	\ˈwit͟h , ˈwith, wət͟h, wəth\
withdraw	 \wit͟h-ˈdrȯ , with-\
within	 \wi-ˈt͟hin , -ˈthin\
without	 \wi-ˈt͟hau̇t , -ˈthau̇t\
witness	 \ˈwit-nəs\
woman	 \ˈwu̇-mən , especially Southern ˈwō-  or ˈwə-\
wonder	 \ˈwən-dər\
wonderful	 \ˈwən-dər-fəl\
wood	\ˈwu̇d\
wooden	 \ˈwu̇-dᵊn\
wool	\ˈwu̇l\
word	\ˈwərd\
work	\ˈwərk\
worker	 \ˈwər-kər\
working	 \ˈwər-kiŋ\
workshop	 \ˈwərk-ˌshäp\
world	\ˈwər(-ə)ld\
worried	\ˈwər-ēd , ˈwə-rēd\
worry	 \ˈwər-ē , ˈwə-rē\
worrying	 \ˈwər-ē-iŋ , ˈwə-rē-\
worse	\ˈwərs\
worth	\ˈwərth\
would	\wəd, əd, d, ˈwu̇d\
wound	\ˈwünd , archaic or dialectal ˈwau̇nd\
wrap	\Ëˆrap\
write	\ˈrīt\
writer	 \ˈrī-tər\
writing	 \ˈrī-tiŋ\
wrong	\ˈrȯŋ\
yard	\ˈyärd\
yeah	\ˈyeə , ˈyaə\
year	\ˈyir\
yellow	 \ˈye-(ˌ)lō , dialectal ˈye-lər or ˈya-\
yep	\ˈyep  or with glottal stop instead of p\
yes	\ˈyes\
yesterday	 \ˈye-stər-(ˌ)dā , -dē\
yet	\ˈyet\
you	\ˈyü , yə also yē\
young	\ˈyəŋ\
youngster	 \ˈyəŋ(k)-stər\
your	\yər, ˈyu̇r , ˈyȯr\
yours	\ˈyu̇rz , ˈyȯrz\
yourself	 \yər-ˈself , Southern also -ˈsef\
youth	\ˈyüth\
zone	\ˈzōn\
